Alias,Women Count,Men Count,Total Voters,Turnout,Perc Turnout,GD Share of the turnout,GD vote count,GD share of the perc turnout,
00.01.01,1474,1037,2511,1527,0.61,0.41192,629,0.25049781,
00.01.02,841,584,1425,923,0.65,0.38028,351,0.246315789,
00.01.03,653,506,1159,710,0.61,0.44366,315,0.271786022,
00.01.04,884,653,1537,931,0.61,0.39635,369,0.240078074,
00.01.05,858,655,1513,1085,0.72,0.41382,449,0.296761401,
00.01.06,807,600,1407,861,0.61,0.37398,322,0.228855721,
00.01.07,911,665,1576,1011,0.64,0.37191,376,0.23857868,
00.01.08,894,605,1499,950,0.63,0.39368,374,0.249499666,
00.01.09,859,623,1482,931,0.63,0.34694,323,0.217948718,
00.01.10,869,606,1475,1017,0.69,0.37365,380,0.257627119,
00.01.11,1448,1080,2528,1534,0.61,0.42829,657,0.259889241,
00.01.12,745,493,1238,783,0.63,0.4636,363,0.293214863,
00.01.13,678,485,1163,775,0.67,0.36774,285,0.24505589,
00.01.14,788,600,1388,909,0.65,0.37954,345,0.248559078,
00.01.15,834,592,1426,937,0.66,0.36393,341,0.239130435,
00.01.16,1396,1065,2461,1652,0.67,0.41223,681,0.276716782,
00.01.17,1314,987,2301,1478,0.64,0.3843,568,0.246849196,
00.01.18,824,617,1441,906,0.63,0.32892,298,0.206800833,
00.01.19,802,573,1375,924,0.67,0.39286,363,0.264,
00.01.20,832,602,1434,1048,0.73,0.38645,405,0.282426778,
00.01.21,790,555,1345,926,0.69,0.37149,344,0.255762082,
00.01.22,908,621,1529,1092,0.71,0.36905,403,0.263570961,
00.01.23,1279,952,2231,1471,0.66,0.41672,613,0.27476468,
00.01.24,1269,1025,2294,1458,0.64,0.41427,604,0.263295554,
00.01.25,972,707,1679,1183,0.7,0.42096,498,0.296605122,
00.01.26,782,571,1353,978,0.72,0.36196,354,0.261640798,
00.01.27,772,553,1325,942,0.71,0.3949,372,0.280754717,
00.01.28,875,598,1473,999,0.68,0.4024,402,0.272912424,
00.01.29,1051,787,1838,1241,0.68,0.45447,564,0.306855277,
00.01.30,606,601,1207,840,0.7,0.49643,417,0.345484673,
00.01.31,765,672,1437,1043,0.73,0.56759,592,0.411969381,
00.01.32,952,840,1792,1232,0.69,0.66802,823,0.459263393,
00.01.33,760,587,1347,892,0.66,0.47085,420,0.311804009,
00.01.34,164,187,351,218,0.62,0.45413,99,0.282051282,
00.02.01,847,638,1485,1115,0.75,0.38924,434,0.292255892,
00.02.02,813,625,1438,1048,0.73,0.39218,411,0.28581363,
00.02.03,943,671,1614,1147,0.71,0.42633,489,0.302973978,
00.02.04,913,661,1574,1129,0.72,0.38175,431,0.273824651,
00.02.05,967,715,1682,1269,0.75,0.42474,539,0.320451843,
00.02.06,802,543,1345,981,0.73,0.3894,382,0.28401487,
00.02.07,623,501,1124,815,0.73,0.37669,307,0.273131673,
00.02.08,961,714,1675,1110,0.66,0.39369,437,0.260895522,
00.02.09,757,589,1346,919,0.68,0.40696,374,0.277860327,
00.02.10,816,551,1367,1000,0.73,0.407,407,0.29773226,
00.02.11,768,557,1325,967,0.73,0.37332,361,0.27245283,
00.02.12,802,588,1390,1040,0.75,0.40769,424,0.305035971,
00.02.13,897,680,1577,1115,0.71,0.40179,448,0.284083703,
00.02.14,978,703,1681,1211,0.72,0.42857,519,0.308744795,
00.02.15,1013,788,1801,1271,0.71,0.40441,514,0.285397002,
00.02.16,723,512,1235,894,0.72,0.41275,369,0.298785425,
00.02.17,739,512,1251,918,0.73,0.40196,369,0.294964029,
00.02.18,914,664,1578,1107,0.7,0.40108,444,0.281368821,
00.02.19,991,734,1725,1006,0.58,0.44036,443,0.256811594,
00.02.20,947,687,1634,1219,0.75,0.37572,458,0.280293758,
00.02.21,883,674,1557,1112,0.71,0.39209,436,0.28002569,
00.02.22,1366,1024,2390,1524,0.64,0.41601,634,0.265271967,
00.02.23,711,499,1210,886,0.73,0.43341,384,0.317355372,
00.02.24,986,742,1728,1165,0.67,0.33476,390,0.225694444,
00.02.25,972,716,1688,1192,0.71,0.40185,479,0.283767773,
00.02.26,990,758,1748,1099,0.63,0.43676,480,0.274599542,
00.02.27,1367,1009,2376,1354,0.57,0.32422,439,0.18476431,
00.02.28,842,694,1536,1038,0.68,0.53179,552,0.359375,
00.02.29,553,472,1025,734,0.72,0.5545,407,0.397073171,
00.02.30,1395,1080,2475,1482,0.6,0.4197,622,0.251313131,
00.02.31,1116,953,2069,1363,0.66,0.50404,687,0.332044466,
00.02.32,1389,1155,2544,1698,0.67,0.34217,581,0.228380503,
00.02.33,811,598,1409,1032,0.73,0.33915,350,0.248403123,
00.02.34,828,581,1409,962,0.68,0.34304,330,0.234208659,
00.02.35,767,562,1329,924,0.7,0.33874,313,0.235515425,
00.02.36,813,506,1319,946,0.72,0.40275,381,0.288855193,
00.02.37,955,645,1600,1144,0.72,0.38112,436,0.2725,
00.02.38,779,490,1269,858,0.68,0.36364,312,0.245862884,
00.02.39,973,615,1588,1100,0.69,0.37818,416,0.261964736,
00.02.40,1019,737,1756,1215,0.69,0.36543,444,0.25284738,
00.02.41,721,542,1263,869,0.69,0.3786,329,0.260490895,
00.02.42,754,545,1299,876,0.67,0.38242,335,0.257890685,
00.02.43,772,526,1298,903,0.7,0.39092,353,0.271956857,
00.02.44,790,540,1330,920,0.69,0.35652,328,0.246616541,
00.02.45,1286,862,2148,1467,0.68,0.35855,526,0.244878957,
00.02.46,1019,672,1691,1152,0.68,0.34375,396,0.234180958,
00.02.47,886,550,1436,940,0.65,0.38298,360,0.250696379,
00.02.48,872,626,1498,1076,0.72,0.39684,427,0.285046729,
00.02.49,743,544,1287,865,0.67,0.39653,343,0.266511267,
00.02.50,1418,958,2376,1549,0.65,0.27954,433,0.182239057,
00.02.51,1215,863,2078,1441,0.69,0.24497,353,0.16987488,
00.02.52,832,596,1428,973,0.68,0.4111,400,0.280112045,
00.02.53,1244,845,2089,1467,0.7,0.3122,458,0.219243657,
00.02.54,1074,802,1876,1312,0.7,0.3468,455,0.242537313,
00.02.55,673,467,1140,774,0.68,0.35271,273,0.239473684,
00.02.56,807,562,1369,941,0.69,0.34006,320,0.233747261,
00.02.57,916,742,1658,1255,0.76,0.37052,465,0.280458384,
00.02.58,966,700,1666,1153,0.69,0.36947,426,0.255702281,
00.02.59,832,553,1385,1037,0.75,0.36933,383,0.276534296,
00.02.60,865,659,1524,1077,0.71,0.36026,388,0.254593176,
00.02.61,775,593,1368,928,0.68,0.33728,313,0.22880117,
00.02.62,1476,1038,2514,1761,0.7,0.33958,598,0.23786794,
00.02.63,772,581,1353,937,0.69,0.35752,335,0.247597931,
00.02.64,390,321,711,403,0.57,0.32258,130,0.182841069,
00.02.65,727,564,1291,927,0.72,0.41316,383,0.296669249,
00.02.66,742,617,1359,948,0.7,0.36814,349,0.256806475,
00.02.67,1403,1065,2468,1786,0.72,0.34378,614,0.248784441,
00.02.68,815,641,1456,984,0.68,0.3872,381,0.261675824,
00.02.69,986,742,1728,1136,0.66,0.35915,408,0.236111111,
00.02.70,286,283,569,412,0.72,0.37621,155,0.272407733,
00.03.01,1043,782,1825,1263,0.69,0.37292,471,0.258082192,
00.03.02,891,656,1547,1070,0.69,0.43832,469,0.303167421,
00.03.03,863,640,1503,1073,0.71,0.36813,395,0.262807718,
00.03.04,707,604,1311,917,0.7,0.3795,348,0.265446224,
00.03.05,996,688,1684,1111,0.66,0.37984,422,0.250593824,
00.03.06,950,711,1661,1093,0.66,0.40622,444,0.26730885,
00.03.07,865,600,1465,978,0.67,0.38344,375,0.255972696,
00.03.08,804,569,1373,966,0.7,0.43892,424,0.308812819,
00.03.09,713,527,1240,863,0.7,0.3905,337,0.271774194,
00.03.10,821,602,1423,994,0.7,0.37223,370,0.260014055,
00.03.11,692,500,1192,840,0.7,0.425,357,0.299496644,
00.03.12,778,504,1282,916,0.71,0.42576,390,0.304212168,
00.03.13,719,494,1213,937,0.77,0.43223,405,0.333882935,
00.03.14,740,539,1279,922,0.72,0.42082,388,0.303362002,
00.03.15,869,618,1487,1062,0.71,0.42185,448,0.30127774,
00.03.16,853,633,1486,935,0.63,0.36791,344,0.231493943,
00.03.17,1011,738,1749,1130,0.65,0.36637,414,0.23670669,
00.03.18,826,645,1471,938,0.64,0.371,348,0.236573759,
00.03.19,867,699,1566,985,0.63,0.38071,375,0.239463602,
00.03.20,724,571,1295,801,0.62,0.39201,314,0.242471042,
00.03.21,800,552,1352,931,0.69,0.39742,370,0.273668639,
00.03.22,872,536,1408,993,0.71,0.37865,376,0.267045455,
00.03.23,838,591,1429,989,0.69,0.39535,391,0.273617915,
00.03.24,778,644,1422,969,0.68,0.40248,390,0.274261603,
00.03.25,848,697,1545,990,0.64,0.38889,385,0.249190939,
00.03.26,829,603,1432,990,0.69,0.35455,351,0.245111732,
00.03.27,589,466,1055,787,0.75,0.38374,302,0.286255924,
00.03.28,833,554,1387,974,0.7,0.38296,373,0.268925739,
00.03.29,748,572,1320,868,0.66,0.37673,327,0.247727273,
00.03.30,889,590,1479,955,0.65,0.37382,357,0.24137931,
00.03.31,857,581,1438,1046,0.73,0.39101,409,0.284422809,
00.03.32,828,571,1399,951,0.68,0.39327,374,0.26733381,
00.03.33,953,789,1742,1148,0.66,0.41289,474,0.272101033,
00.03.34,874,640,1514,955,0.63,0.39476,377,0.249009247,
00.03.35,1450,1148,2598,1526,0.59,0.47444,724,0.278675905,
00.03.36,808,595,1403,994,0.71,0.35915,357,0.25445474,
00.03.37,1347,952,2299,1602,0.7,0.33208,532,0.231404959,
00.03.38,697,544,1241,827,0.67,0.40629,336,0.270749396,
00.03.39,781,562,1343,973,0.72,0.39466,384,0.285927029,
00.03.40,853,577,1430,989,0.69,0.34277,339,0.237062937,
00.03.41,860,648,1508,1075,0.71,0.36279,390,0.25862069,
00.03.42,894,616,1510,1012,0.67,0.39328,398,0.263576159,
00.03.43,729,553,1282,834,0.65,0.33693,281,0.219188768,
00.03.44,884,642,1526,1071,0.7,0.38749,415,0.271952818,
00.03.45,835,579,1414,1020,0.72,0.38725,395,0.279349364,
00.03.46,741,545,1286,950,0.74,0.38421,365,0.283825816,
00.03.47,858,590,1448,998,0.69,0.3978,397,0.274171271,
00.03.48,878,602,1480,1054,0.71,0.4203,443,0.299324324,
00.03.49,855,588,1443,1028,0.71,0.40759,419,0.29036729,
00.03.50,848,630,1478,1096,0.74,0.39325,431,0.291610284,
00.03.51,859,642,1501,1163,0.77,0.37919,441,0.293804131,
00.03.52,774,531,1305,785,0.6,0.38089,299,0.229118774,
00.03.53,836,664,1500,1119,0.75,0.42717,478,0.318666667,
00.03.54,738,604,1342,1004,0.75,0.42231,424,0.315946349,
00.03.55,849,611,1460,923,0.63,0.40087,370,0.253424658,
00.03.56,869,671,1540,972,0.63,0.41358,402,0.261038961,
00.03.57,866,627,1493,1088,0.73,0.3943,429,0.287340924,
00.03.58,903,633,1536,1061,0.69,0.41188,437,0.284505208,
00.03.59,850,635,1485,1020,0.69,0.3902,398,0.268013468,
00.03.60,723,541,1264,881,0.7,0.40976,361,0.285601266,
00.03.61,815,506,1321,941,0.71,0.40701,383,0.28993187,
00.03.62,978,738,1716,1165,0.68,0.36996,431,0.251165501,
00.03.63,936,818,1754,1105,0.63,0.37285,412,0.234891676,
00.03.64,1770,1437,3207,1881,0.59,0.48113,905,0.282195198,
00.03.65,542,466,1008,697,0.69,0.43902,306,0.303571429,
00.03.66,833,711,1544,932,0.6,0.52575,490,0.317357513,
00.03.67,920,811,1731,980,0.57,0.5051,495,0.285961872,
00.03.68,1048,837,1885,1119,0.59,0.52726,590,0.312997347,
00.03.69,739,676,1415,887,0.63,0.51409,456,0.322261484,
00.03.70,722,672,1394,827,0.59,0.50544,418,0.299856528,
00.03.71,938,673,1611,1026,0.64,0.32749,336,0.208566108,
00.03.72,1924,1415,3339,2229,0.67,0.34096,760,0.227613058,
00.03.73,962,756,1718,1179,0.69,0.36387,429,0.249708964,
00.03.74,839,671,1510,1038,0.69,0.35742,371,0.245695364,
00.03.75,911,636,1547,1113,0.72,0.40162,447,0.288946348,
00.03.76,1817,1398,3215,2133,0.66,0.3985,850,0.264385692,
00.03.77,660,516,1176,799,0.68,0.4005,320,0.272108844,
00.03.78,731,607,1338,861,0.64,0.3554,306,0.228699552,
00.03.79,1003,734,1737,1117,0.64,0.37064,414,0.238341969,
00.03.80,813,601,1414,983,0.7,0.39573,389,0.275106082,
00.03.81,803,593,1396,962,0.69,0.40644,391,0.28008596,
00.03.82,800,602,1402,944,0.67,0.43538,411,0.293152639,
00.03.83,891,719,1610,1078,0.67,0.42208,455,0.282608696,
00.03.84,1223,868,2091,1336,0.64,0.36003,481,0.230033477,
00.03.85,766,603,1369,881,0.64,0.34279,302,0.220598977,
00.03.86,764,611,1375,869,0.63,0.41772,363,0.264,
00.03.87,1066,776,1842,1119,0.61,0.31903,357,0.193811075,
00.03.88,810,611,1421,909,0.64,0.38174,347,0.244194229,
00.03.89,1428,1130,2558,1723,0.67,0.34068,587,0.229476153,
00.03.90,986,775,1761,1076,0.61,0.47119,507,0.2879046,
00.03.91,1421,1184,2605,1605,0.62,0.43614,700,0.268714012,
00.04.01,745,510,1255,685,0.55,0.43942,301,0.239840637,
00.04.02,1537,1114,2651,1478,0.56,0.39648,586,0.221048661,
00.04.03,1445,1017,2462,1302,0.53,0.43472,566,0.229894395,
00.04.04,1400,1029,2429,1267,0.52,0.53039,672,0.276657061,
00.04.05,1335,1049,2384,1252,0.53,0.54233,679,0.284815436,
00.04.06,1318,1013,2331,1344,0.58,0.40923,550,0.235950236,
00.04.07,819,710,1529,840,0.55,0.47857,402,0.262916939,
00.04.08,1037,805,1842,1163,0.63,0.47549,553,0.300217155,
00.04.09,929,708,1637,908,0.55,0.51872,471,0.287721442,
00.04.10,896,660,1556,1012,0.65,0.48715,493,0.316838046,
00.04.11,985,764,1749,1137,0.65,0.44151,502,0.287021155,
00.04.12,884,640,1524,940,0.62,0.4734,445,0.291994751,
00.04.13,1463,1094,2557,1424,0.56,0.46138,657,0.256941729,
00.04.14,1471,1194,2665,1418,0.53,0.49718,705,0.264540338,
00.04.15,1109,876,1985,1114,0.56,0.47487,529,0.266498741,
00.04.16,914,685,1599,694,0.43,0.64553,448,0.280175109,
00.04.17,1597,1222,2819,1521,0.54,0.4714,717,0.254345513,
00.04.18,746,608,1354,789,0.58,0.47148,372,0.274741507,
00.04.19,722,605,1327,818,0.62,0.45966,376,0.283345893,
00.04.20,1609,1391,3000,941,0.31,0.72582,683,0.227666667,
00.04.21,735,638,1373,503,0.37,0.6163,310,0.225782957,
00.05.01,1767,1379,3146,1543,0.49,0.50162,774,0.246026701,
00.05.02,1672,1371,3043,1416,0.47,0.61441,870,0.28590207,
00.05.03,1640,1229,2869,1415,0.49,0.47986,679,0.236667829,
00.05.04,891,664,1555,849,0.55,0.45936,390,0.250803859,
00.05.05,744,529,1273,652,0.51,0.45859,299,0.23487824,
00.05.06,1524,1108,2632,1426,0.54,0.47195,673,0.255699088,
00.05.07,900,678,1578,851,0.54,0.40893,348,0.220532319,
00.05.08,898,668,1566,877,0.56,0.43101,378,0.24137931,
00.05.09,881,691,1572,854,0.54,0.46604,398,0.253180662,
00.05.10,896,666,1562,895,0.57,0.42682,382,0.244558259,
00.05.11,1640,1202,2842,1574,0.55,0.49682,782,0.275158339,
00.05.12,1631,1159,2790,1613,0.58,0.45071,727,0.260573477,
00.05.13,1556,1137,2693,1414,0.53,0.46747,661,0.24545117,
00.05.14,994,766,1760,970,0.55,0.47216,458,0.260227273,
00.05.15,952,673,1625,1022,0.63,0.46184,472,0.290461538,
00.05.16,869,658,1527,859,0.56,0.46217,397,0.259986902,
00.05.17,898,679,1577,910,0.58,0.44066,401,0.254280279,
00.05.18,1565,1118,2683,1453,0.54,0.47213,686,0.255683936,
00.05.19,832,631,1463,863,0.59,0.4044,349,0.238550923,
00.05.20,901,721,1622,847,0.52,0.44982,381,0.234895191,
00.05.21,835,614,1449,849,0.59,0.46643,396,0.273291925,
00.05.22,1096,822,1918,1083,0.56,0.41644,451,0.235140772,
00.05.23,1004,735,1739,888,0.51,0.43581,387,0.222541691,
00.05.24,935,774,1709,881,0.52,0.44495,392,0.229373903,
00.05.25,1515,1248,2763,1240,0.45,0.43871,544,0.196887441,
00.05.26,895,623,1518,933,0.61,0.42337,395,0.260210804,
00.05.27,966,815,1781,941,0.53,0.44527,419,0.235261089,
00.05.28,792,647,1439,873,0.61,0.42955,375,0.260597637,
00.05.29,750,636,1386,913,0.66,0.48193,440,0.317460317,
00.05.30,1198,1012,2210,1211,0.55,0.5929,718,0.324886878,
00.05.31,1711,1457,3168,1471,0.46,0.50102,737,0.232638889,
00.05.32,1562,1301,2863,1315,0.46,0.47072,619,0.216206776,
00.05.33,646,639,1285,636,0.49,0.44497,283,0.220233463,
00.05.34,1687,1390,3077,1380,0.45,0.50217,693,0.22521937,
00.05.35,534,425,959,442,0.46,0.56561,250,0.260688217,
00.05.36,748,592,1340,786,0.59,0.42366,333,0.248507463,
00.05.37,711,508,1219,714,0.59,0.42997,307,0.251845775,
00.05.38,903,746,1649,1012,0.61,0.39921,404,0.244996968,
00.05.39,1491,1060,2551,1276,0.5,0.41771,533,0.208937672,
00.05.40,1293,1026,2319,1356,0.58,0.48599,659,0.284174213,
00.05.41,1125,767,1892,976,0.52,0.35348,345,0.182346723,
00.05.42,1664,1265,2929,1646,0.56,0.41616,685,0.233868214,
00.05.43,1459,1101,2560,1497,0.58,0.46025,689,0.269140625,
00.05.44,964,742,1706,1020,0.6,0.41275,421,0.246776084,
00.05.45,792,571,1363,752,0.55,0.38298,288,0.211298606,
00.05.46,1679,1304,2983,1567,0.53,0.38928,610,0.204492122,
00.05.47,725,480,1205,738,0.61,0.46883,346,0.287136929,
00.05.48,768,565,1333,726,0.54,0.47107,342,0.256564141,
00.05.49,872,624,1496,889,0.59,0.46007,409,0.273395722,
00.05.50,726,611,1337,748,0.56,0.44118,330,0.246821242,
00.05.51,1755,1361,3116,1710,0.55,0.44327,758,0.243260591,
00.05.52,1678,1301,2979,1564,0.53,0.40217,629,0.211144679,
00.05.53,1562,1245,2807,1498,0.53,0.43391,650,0.231563947,
00.05.54,1674,1325,2999,1744,0.58,0.44553,777,0.259086362,
00.05.55,1381,1076,2457,1378,0.56,0.41437,571,0.232397232,
00.05.56,966,740,1706,984,0.58,0.4624,455,0.266705744,
00.05.57,1561,1259,2820,1589,0.56,0.40214,639,0.226595745,
00.06.01,1285,947,2232,1234,0.55,0.42464,524,0.234767025,
00.06.02,1391,1084,2475,1350,0.55,0.42593,575,0.232323232,
00.06.03,1311,992,2303,1268,0.55,0.42902,544,0.236213634,
00.06.04,1284,1034,2318,1341,0.58,0.45116,605,0.261000863,
00.06.05,1395,1049,2444,1349,0.55,0.4129,557,0.227905074,
00.06.06,720,563,1283,775,0.6,0.46065,357,0.278254092,
00.06.07,1500,1119,2619,1510,0.58,0.42119,636,0.242840779,
00.06.08,1285,967,2252,1337,0.59,0.44727,598,0.265541741,
00.06.09,899,724,1623,920,0.57,0.38587,355,0.218730746,
00.06.10,767,617,1384,782,0.57,0.38491,301,0.217485549,
00.06.11,1547,1163,2710,1556,0.57,0.40488,630,0.232472325,
00.06.12,1442,1136,2578,1433,0.56,0.41103,589,0.228471683,
00.06.13,1483,1100,2583,1477,0.57,0.41909,619,0.239643825,
00.06.14,1306,952,2258,1308,0.58,0.43731,572,0.253321523,
00.06.15,1515,1146,2661,1563,0.59,0.44402,694,0.260804209,
00.06.16,1549,1134,2683,1534,0.57,0.42112,646,0.240775252,
00.06.17,1657,1192,2849,1642,0.58,0.40621,667,0.234117234,
00.06.18,1362,985,2347,1211,0.52,0.41701,505,0.2151683,
00.06.19,1237,867,2104,1051,0.5,0.46147,485,0.230513308,
00.06.20,1455,1086,2541,1407,0.55,0.40867,575,0.226288863,
00.06.21,811,578,1389,822,0.59,0.44526,366,0.26349892,
00.06.22,645,486,1131,693,0.61,0.41847,290,0.256410256,
00.06.23,1871,1365,3236,1640,0.51,0.41707,684,0.211372064,
00.06.24,1434,1129,2563,1330,0.52,0.44211,588,0.22941865,
00.06.25,1357,979,2336,1300,0.56,0.43538,566,0.242294521,
00.06.26,1499,1055,2554,1314,0.51,0.43303,569,0.222787784,
00.06.27,1033,839,1872,942,0.5,0.46391,437,0.233440171,
00.06.28,693,507,1200,601,0.5,0.44426,267,0.2225,
00.06.29,1610,1193,2803,1458,0.52,0.47668,695,0.247948626,
00.06.30,1563,1138,2701,1432,0.53,0.43087,617,0.228433913,
00.06.31,1807,1447,3254,1728,0.53,0.42766,739,0.227105101,
00.06.32,1619,1161,2780,1415,0.51,0.44594,631,0.226978417,
00.06.33,1489,1089,2578,1389,0.54,0.46292,643,0.249418154,
00.06.34,753,588,1341,740,0.55,0.43919,325,0.24235645,
00.06.35,738,620,1358,784,0.58,0.48342,379,0.279086892,
00.06.36,881,714,1595,841,0.53,0.46136,388,0.243260188,
00.06.37,1241,1010,2251,1218,0.54,0.54762,667,0.29631275,
00.06.38,1629,1291,2920,1529,0.52,0.46828,716,0.245205479,
00.06.39,1326,1078,2404,1260,0.52,0.4619,582,0.242096506,
00.06.40,1615,1278,2893,1377,0.48,0.52433,722,0.249567923,
00.06.41,1584,1267,2851,1380,0.48,0.50725,700,0.245527885,
00.06.42,1260,1048,2308,1237,0.54,0.5772,714,0.309358752,
00.06.43,291,261,552,352,0.64,0.52841,186,0.336956522,
00.06.44,1403,1222,2625,1573,0.6,0.45137,710,0.27047619,
00.06.45,1062,886,1948,1292,0.66,0.54567,705,0.361909651,
00.06.46,572,557,1129,635,0.56,0.45669,290,0.256864482,
00.06.47,561,480,1041,506,0.49,0.55534,281,0.269932757,
00.06.48,1557,1279,2836,1811,0.64,0.545,987,0.348025388,
00.06.49,742,633,1375,570,0.41,0.4193,239,0.173818182,
00.06.50,758,592,1350,1040,0.77,0.6,624,0.462222222,
00.06.51,1171,960,2131,1037,0.49,0.4378,454,0.213045519,
00.06.52,1669,1274,2943,1421,0.48,0.44124,627,0.21304791,
00.06.53,1518,1174,2692,1380,0.51,0.44058,608,0.225854383,
00.06.54,1019,794,1813,792,0.44,0.48106,381,0.210148924,
00.06.55,787,650,1437,660,0.46,0.4803,317,0.220598469,
00.06.56,818,673,1491,836,0.56,0.45215,378,0.253521127,
00.06.57,905,733,1638,780,0.48,0.45385,354,0.216117216,
00.06.58,1400,1078,2478,1378,0.56,0.40203,554,0.223567393,
00.06.59,1072,865,1937,1213,0.63,0.45672,554,0.286009293,
00.06.60,677,538,1215,652,0.54,0.41871,273,0.224691358,
00.06.61,679,531,1210,761,0.63,0.45466,346,0.285950413,
00.06.62,776,599,1375,853,0.62,0.3728,318,0.231272727,
00.06.63,1428,1111,2539,1465,0.58,0.45597,668,0.263095707,
00.06.64,658,527,1185,617,0.52,0.45219,279,0.235443038,
00.06.65,770,674,1444,760,0.53,0.44079,335,0.23199446,
00.06.66,1544,1085,2629,1496,0.57,0.43249,647,0.246101179,
00.06.67,1171,902,2073,1175,0.57,0.46979,552,0.266280753,
00.06.68,1225,940,2165,1214,0.56,0.45634,554,0.255889145,
00.06.69,557,422,979,588,0.6,0.43707,257,0.262512768,
00.06.70,864,586,1450,816,0.56,0.39338,321,0.22137931,
00.06.71,943,647,1590,951,0.6,0.37224,354,0.222641509,
00.06.72,1289,1079,2368,1281,0.54,0.41686,534,0.225506757,
00.07.01,748,555,1303,875,0.67,0.46857,410,0.31465848,
00.07.02,770,609,1379,867,0.63,0.43368,376,0.272661349,
00.07.03,725,527,1252,705,0.56,0.43546,307,0.245207668,
00.07.04,877,630,1507,923,0.61,0.40953,378,0.250829463,
00.07.05,685,583,1268,606,0.48,0.41584,252,0.19873817,
00.07.06,834,649,1483,844,0.57,0.47275,399,0.269049225,
00.07.07,914,596,1510,944,0.63,0.41843,395,0.261589404,
00.07.08,808,614,1422,857,0.6,0.43874,376,0.264416315,
00.07.09,859,608,1467,912,0.62,0.46491,424,0.289025222,
00.07.10,1377,976,2353,1482,0.63,0.45547,675,0.286867828,
00.07.11,900,628,1528,895,0.59,0.45698,409,0.267670157,
00.07.12,1378,998,2376,1505,0.63,0.47243,711,0.299242424,
00.07.13,1127,840,1967,1173,0.6,0.39898,468,0.237925775,
00.07.14,1498,1086,2584,1578,0.61,0.46008,726,0.280959752,
00.07.15,900,671,1571,998,0.64,0.40982,409,0.26034373,
00.07.16,837,690,1527,947,0.62,0.42027,398,0.260641781,
00.07.17,929,680,1609,953,0.59,0.41028,391,0.24300808,
00.07.18,889,719,1608,996,0.62,0.501,499,0.310323383,
00.07.19,1326,963,2289,1342,0.59,0.43666,586,0.25600699,
00.07.20,908,689,1597,825,0.52,0.51394,424,0.265497808,
00.07.21,857,681,1538,977,0.64,0.42886,419,0.27243173,
00.07.22,813,613,1426,831,0.58,0.45969,382,0.267882188,
00.07.23,1632,1171,2803,1602,0.57,0.43383,695,0.247948626,
00.07.24,947,676,1623,1015,0.63,0.4798,487,0.300061614,
00.07.25,1586,1132,2718,1731,0.64,0.42577,737,0.271155261,
00.07.26,1136,807,1943,1277,0.66,0.39859,509,0.261966032,
00.07.27,1162,882,2044,1238,0.61,0.39661,491,0.240215264,
00.07.28,698,498,1196,807,0.67,0.39281,317,0.265050167,
00.07.29,784,577,1361,834,0.61,0.39448,329,0.241734019,
00.07.30,696,542,1238,768,0.62,0.4362,335,0.270597738,
00.07.31,920,673,1593,944,0.59,0.44492,420,0.263653484,
00.07.32,785,654,1439,843,0.59,0.54093,456,0.316886727,
00.07.33,911,612,1523,911,0.6,0.41054,374,0.245567958,
00.07.34,801,599,1400,869,0.62,0.42348,368,0.262857143,
00.07.35,788,579,1367,809,0.59,0.42027,340,0.248719824,
00.07.36,625,440,1065,667,0.63,0.50225,335,0.314553991,
00.07.37,780,574,1354,844,0.62,0.46682,394,0.29098966,
00.07.38,794,519,1313,752,0.57,0.43484,327,0.249047982,
00.07.39,1039,898,1937,1264,0.65,0.42563,538,0.277749097,
00.07.40,741,627,1368,756,0.55,0.52249,395,0.28874269,
00.07.41,761,623,1384,840,0.61,0.47619,400,0.289017341,
00.08.01,831,610,1441,877,0.61,0.44698,392,0.27203331,
00.08.02,676,524,1200,829,0.69,0.40169,333,0.2775,
00.08.03,882,636,1518,980,0.65,0.41122,403,0.265480896,
00.08.04,708,513,1221,822,0.67,0.40754,335,0.274365274,
00.08.05,723,536,1259,808,0.64,0.47153,381,0.302621128,
00.08.06,770,652,1422,943,0.66,0.40297,380,0.267229255,
00.08.07,704,479,1183,803,0.68,0.39228,315,0.266272189,
00.08.08,701,524,1225,779,0.64,0.42234,329,0.268571429,
00.08.09,960,720,1680,1097,0.65,0.39471,433,0.257738095,
00.08.10,422,256,678,461,0.68,0.42082,194,0.286135693,
00.08.11,1250,922,2172,1385,0.64,0.39206,543,0.25,
00.08.12,1413,984,2397,1522,0.63,0.43101,656,0.273675428,
00.08.13,653,459,1112,734,0.66,0.39782,292,0.262589928,
00.08.14,635,446,1081,746,0.69,0.43834,327,0.302497687,
00.08.15,1310,975,2285,1366,0.6,0.43119,589,0.257768053,
00.08.16,856,653,1509,907,0.6,0.44983,408,0.270377734,
00.08.17,903,672,1575,994,0.63,0.45875,456,0.28952381,
00.08.18,964,742,1706,1073,0.63,0.44921,482,0.282532239,
00.08.19,922,693,1615,1079,0.67,0.45042,486,0.300928793,
00.08.20,1003,734,1737,1210,0.7,0.42066,509,0.293033967,
00.08.21,650,444,1094,711,0.65,0.44444,316,0.288848263,
00.08.22,879,619,1498,1031,0.69,0.39379,406,0.271028037,
00.08.23,780,556,1336,904,0.68,0.40044,362,0.270958084,
00.08.24,777,514,1291,882,0.68,0.39456,348,0.269558482,
00.08.25,650,460,1110,745,0.67,0.46309,345,0.310810811,
00.08.26,1324,958,2282,1538,0.67,0.42913,660,0.289219982,
00.08.27,1327,970,2297,1547,0.67,0.3969,614,0.267305181,
00.08.28,693,453,1146,813,0.71,0.43419,353,0.308027923,
00.08.29,1008,702,1710,1175,0.69,0.4034,474,0.277192982,
00.08.30,1042,695,1737,1187,0.68,0.39511,469,0.270005757,
00.08.31,738,563,1301,863,0.66,0.41831,361,0.277478862,
00.08.32,1343,883,2226,1524,0.68,0.41864,638,0.286612758,
00.08.33,456,353,809,631,0.78,0.47068,297,0.367119901,
00.08.34,670,469,1139,820,0.72,0.38049,312,0.273924495,
00.08.35,1328,948,2276,1504,0.66,0.46809,704,0.309314587,
00.08.36,678,450,1128,824,0.73,0.46359,382,0.338652482,
00.08.37,828,576,1404,940,0.67,0.41596,391,0.278490028,
00.08.38,1346,947,2293,1544,0.67,0.43394,670,0.292193633,
00.08.39,1062,811,1873,1246,0.67,0.33788,421,0.224773091,
00.08.40,986,765,1751,1118,0.64,0.4195,469,0.267846945,
00.09.01,1441,1264,2705,1253,0.46,0.56504,708,0.261737523,
00.09.02,1380,1179,2559,1467,0.57,0.48057,705,0.275498242,
00.09.03,1443,1167,2610,1492,0.57,0.46448,693,0.265517241,
00.09.04,1586,1243,2829,1579,0.56,0.47182,745,0.263343938,
00.09.05,1317,1171,2488,1315,0.53,0.40456,532,0.213826367,
00.09.06,712,601,1313,750,0.57,0.42933,322,0.245239909,
00.09.07,791,690,1481,955,0.64,0.47016,449,0.303173531,
00.09.08,794,618,1412,909,0.64,0.48295,439,0.310906516,
00.09.09,824,672,1496,858,0.57,0.47319,406,0.271390374,
00.09.10,866,615,1481,861,0.58,0.4158,358,0.241728562,
00.09.11,825,685,1510,880,0.58,0.43295,381,0.252317881,
00.09.12,825,591,1416,864,0.61,0.4375,378,0.266949153,
00.09.13,874,611,1485,925,0.62,0.4573,423,0.284848485,
00.09.14,833,634,1467,991,0.68,0.46519,461,0.314246762,
00.09.15,811,636,1447,941,0.65,0.54516,513,0.354526607,
00.09.16,848,584,1432,923,0.64,0.46154,426,0.297486034,
00.09.17,654,478,1132,773,0.68,0.43596,337,0.29770318,
00.09.18,751,657,1408,864,0.61,0.47222,408,0.289772727,
00.09.19,762,553,1315,778,0.59,0.46015,358,0.272243346,
00.09.20,733,569,1302,864,0.66,0.42824,370,0.284178187,
00.09.21,753,594,1347,773,0.57,0.49159,380,0.282108389,
00.09.22,1261,1015,2276,1368,0.6,0.40058,548,0.240773286,
00.09.23,696,524,1220,709,0.58,0.39915,283,0.231967213,
00.09.24,779,630,1409,853,0.61,0.45604,389,0.276082328,
00.09.25,784,611,1395,746,0.53,0.43432,324,0.232258065,
00.09.26,764,600,1364,854,0.63,0.42272,361,0.264662757,
00.09.27,750,538,1288,765,0.59,0.39739,304,0.236024845,
00.09.28,703,517,1220,758,0.62,0.43404,329,0.269672131,
00.09.29,1622,1321,2943,1437,0.49,0.42937,617,0.209650017,
00.09.30,797,658,1455,809,0.56,0.4623,374,0.257044674,
00.09.31,637,473,1110,673,0.61,0.40267,271,0.244144144,
00.09.32,817,611,1428,831,0.58,0.4272,355,0.24859944,
00.09.33,854,635,1489,870,0.58,0.42989,374,0.251175285,
00.09.34,780,649,1429,810,0.57,0.45802,371,0.259622113,
00.09.35,844,676,1520,833,0.55,0.43457,362,0.238157895,
00.09.36,885,750,1635,929,0.57,0.43595,405,0.247706422,
00.09.37,799,567,1366,824,0.6,0.45388,374,0.273792094,
00.09.38,1915,1326,3241,1999,0.62,0.37619,752,0.232027152,
00.09.39,1477,1141,2618,1512,0.58,0.43981,665,0.254010695,
00.09.40,720,554,1274,747,0.59,0.42436,317,0.248822606,
00.09.41,573,474,1047,540,0.52,0.44444,240,0.229226361,
00.09.42,722,572,1294,838,0.65,0.4642,389,0.300618238,
00.09.43,751,523,1274,848,0.67,0.47288,401,0.314756672,
00.09.44,795,596,1391,860,0.62,0.40233,346,0.248741912,
00.09.45,838,636,1474,968,0.66,0.41322,400,0.271370421,
00.09.46,843,637,1480,968,0.65,0.45868,444,0.3,
00.09.47,820,651,1471,872,0.59,0.38073,332,0.225696805,
00.09.48,828,658,1486,876,0.59,0.46575,408,0.274562584,
00.09.49,704,566,1270,772,0.61,0.49611,383,0.301574803,
00.09.50,707,541,1248,780,0.63,0.40513,316,0.253205128,
00.09.51,823,607,1430,873,0.61,0.36541,319,0.223076923,
00.09.52,1458,976,2434,1543,0.63,0.38432,593,0.243631882,
00.09.53,612,513,1125,609,0.54,0.41051,250,0.222222222,
00.09.54,716,580,1296,856,0.66,0.41121,352,0.271604938,
00.09.55,821,625,1446,849,0.59,0.42756,363,0.251037344,
00.09.56,1477,1043,2520,1408,0.56,0.38636,544,0.215873016,
00.09.57,830,670,1500,875,0.58,0.39657,347,0.231333333,
00.09.58,837,665,1502,928,0.62,0.38793,360,0.239680426,
00.09.59,1498,1235,2733,1644,0.6,0.38625,635,0.232345408,
00.09.60,741,671,1412,813,0.58,0.43419,353,0.25,
00.09.61,885,658,1543,1000,0.65,0.339,339,0.219701879,
00.09.62,745,543,1288,759,0.59,0.37681,286,0.222049689,
00.09.63,826,614,1440,860,0.6,0.36628,315,0.21875,
00.09.64,791,627,1418,733,0.52,0.39836,292,0.205923836,
00.09.65,828,639,1467,970,0.66,0.42062,408,0.278118609,
00.09.66,790,581,1371,782,0.57,0.38747,303,0.221006565,
00.09.67,798,596,1394,865,0.62,0.4185,362,0.259684362,
00.09.68,890,645,1535,869,0.57,0.41312,359,0.233876221,
00.09.69,865,693,1558,948,0.61,0.39768,377,0.241976893,
00.09.70,796,588,1384,819,0.59,0.40904,335,0.242052023,
00.09.71,836,612,1448,882,0.61,0.34807,307,0.212016575,
00.09.72,1442,1114,2556,1401,0.55,0.36188,507,0.198356808,
00.09.73,948,672,1620,925,0.57,0.39459,365,0.225308642,
00.09.74,773,576,1349,832,0.62,0.375,312,0.231282431,
00.09.75,785,539,1324,770,0.58,0.44156,340,0.256797583,
00.09.76,966,802,1768,1035,0.59,0.38454,398,0.225113122,
00.09.77,1460,1064,2524,1509,0.6,0.39894,602,0.238510301,
00.09.78,1350,1024,2374,1420,0.6,0.44718,635,0.267481045,
00.09.79,1532,1122,2654,1480,0.56,0.42297,626,0.235870384,
00.09.80,1477,1061,2538,1484,0.58,0.43329,643,0.253349094,
00.09.81,1433,1181,2614,1514,0.58,0.40951,620,0.237184392,
00.10.01,941,707,1648,988,0.6,0.4504,445,0.270024272,
00.10.02,875,734,1609,895,0.56,0.42235,378,0.234928527,
00.10.03,877,676,1553,847,0.55,0.44038,373,0.240180296,
00.10.04,1209,1046,2255,1267,0.56,0.4562,578,0.25631929,
00.10.05,823,719,1542,889,0.58,0.41957,373,0.241893645,
00.10.06,1662,1344,3006,1682,0.56,0.42152,709,0.23586161,
00.10.07,1514,1191,2705,1460,0.54,0.4089,597,0.220702403,
00.10.08,1564,1312,2876,1558,0.54,0.45571,710,0.246870654,
00.10.09,1745,1359,3104,1743,0.56,0.43775,763,0.245811856,
00.10.10,834,618,1452,912,0.63,0.39254,358,0.246556474,
00.10.11,716,581,1297,819,0.63,0.47131,386,0.297609869,
00.10.12,752,568,1320,734,0.56,0.4564,335,0.253787879,
00.10.13,724,567,1291,770,0.6,0.48701,375,0.290472502,
00.10.14,398,333,731,408,0.56,0.48039,196,0.268125855,
00.10.15,1214,937,2151,1274,0.59,0.44349,565,0.262668526,
00.10.16,1669,1384,3053,1628,0.53,0.45209,736,0.241074353,
00.10.17,1370,1059,2429,1424,0.59,0.41573,592,0.243721696,
00.10.18,1173,1123,2296,1216,0.53,0.45477,553,0.240853659,
00.10.19,1780,1218,2998,1671,0.56,0.39737,664,0.221480987,
00.10.20,972,690,1662,957,0.58,0.3908,374,0.225030084,
00.10.21,1833,1401,3234,1766,0.55,0.36693,648,0.200371058,
00.10.22,866,645,1511,898,0.59,0.40869,367,0.242885506,
00.10.23,1601,1252,2853,1587,0.56,0.38815,616,0.215913074,
00.10.24,728,590,1318,724,0.55,0.38122,276,0.209408194,
00.10.25,842,591,1433,783,0.55,0.41762,327,0.228192603,
00.10.26,722,528,1250,759,0.61,0.49012,372,0.2976,
00.10.27,1477,1119,2596,1362,0.52,0.38987,531,0.204545455,
00.10.28,1458,1096,2554,1486,0.58,0.41117,611,0.239232576,
00.10.29,820,680,1500,861,0.57,0.42509,366,0.244,
00.10.30,1791,1466,3257,1632,0.5,0.39706,648,0.198956095,
00.10.31,1335,1061,2396,1336,0.56,0.41542,555,0.23163606,
00.10.32,672,448,1120,607,0.54,0.38386,233,0.208035714,
00.10.33,1688,1228,2916,1609,0.55,0.37725,607,0.208161866,
00.10.34,1451,1081,2532,1425,0.56,0.38456,548,0.2164297,
00.10.35,852,642,1494,869,0.58,0.36479,317,0.212182062,
00.10.36,795,613,1408,829,0.59,0.34017,282,0.200284091,
00.10.37,1263,890,2153,1254,0.58,0.40271,505,0.234556433,
00.10.38,872,773,1645,972,0.59,0.43621,424,0.25775076,
00.10.39,1135,922,2057,1044,0.51,0.35345,369,0.179387457,
00.10.40,831,844,1675,796,0.48,0.38568,307,0.183283582,
00.10.41,845,659,1504,795,0.53,0.38113,303,0.201462766,
00.10.42,853,688,1541,858,0.56,0.38345,329,0.213497729,
00.10.43,784,559,1343,792,0.59,0.41414,328,0.244229337,
00.10.44,1493,1106,2599,1462,0.56,0.39877,583,0.224317045,
00.10.45,1537,1148,2685,1507,0.56,0.40146,605,0.225325885,
00.10.46,821,657,1478,891,0.6,0.42088,375,0.253721245,
00.10.47,1000,805,1805,1092,0.6,0.41209,450,0.249307479,
00.10.48,865,694,1559,911,0.58,0.3831,349,0.22386145,
00.10.49,765,618,1383,845,0.61,0.35621,301,0.217642805,
00.10.50,869,619,1488,921,0.62,0.45385,418,0.280913978,
00.10.51,1457,1107,2564,1469,0.57,0.39346,578,0.225429017,
00.10.52,1369,1001,2370,1422,0.6,0.40436,575,0.242616034,
00.10.53,1612,1191,2803,1545,0.55,0.36117,558,0.199072422,
00.10.54,1254,973,2227,1284,0.58,0.37461,481,0.215985631,
00.10.55,1066,755,1821,1041,0.57,0.40922,426,0.233937397,
00.10.56,700,531,1231,685,0.56,0.38978,267,0.216896832,
00.10.57,669,499,1168,683,0.58,0.39531,270,0.231164384,
00.10.58,515,450,965,543,0.56,0.45856,249,0.258031088,
00.10.59,714,561,1275,765,0.6,0.38431,294,0.230588235,
00.10.60,1009,667,1676,952,0.57,0.36975,352,0.210023866,
00.10.61,1509,1131,2640,1400,0.53,0.41143,576,0.218181818,
00.10.62,1475,1079,2554,1567,0.61,0.39119,613,0.240015662,
00.10.63,848,616,1464,864,0.59,0.40509,350,0.239071038,
00.10.64,1401,973,2374,1498,0.63,0.39252,588,0.247683235,
00.10.65,1546,1145,2691,1582,0.59,0.36852,583,0.216648086,
00.10.66,875,701,1576,942,0.6,0.3397,320,0.203045685,
00.10.67,1385,1032,2417,1517,0.63,0.35662,541,0.223831196,
00.10.68,712,560,1272,790,0.62,0.39241,310,0.243710692,
00.10.69,1214,914,2128,1198,0.56,0.37479,449,0.210996241,
00.10.70,824,696,1520,914,0.6,0.42451,388,0.255263158,
00.10.71,800,609,1409,829,0.59,0.41496,344,0.244144784,
00.10.72,1461,1118,2579,1574,0.61,0.38882,612,0.23730128,
00.10.73,1302,1036,2338,1404,0.6,0.41595,584,0.249786142,
00.10.74,1361,1097,2458,1365,0.56,0.39487,539,0.219283971,
00.10.75,1824,1463,3287,1837,0.56,0.41807,768,0.233647703,
00.10.76,0,0,0,403,0,0.82134,331,0,
00.10.77,0,0,0,129,0,0.82171,106,0,
00.11.01,975,855,1830,1136,0.62,0.61796,702,0.383606557,
00.11.02,360,325,685,442,0.65,0.60181,266,0.388321168,
00.11.03,1176,1010,2186,1414,0.65,0.60113,850,0.38883806,
00.11.04,899,828,1727,1104,0.64,0.60326,666,0.385639838,
00.11.05,731,665,1396,826,0.59,0.59806,494,0.353868195,
00.11.06,1013,831,1844,984,0.53,0.4939,486,0.263557484,
00.11.07,432,441,873,517,0.59,0.68859,356,0.407789233,
00.11.08,164,176,340,231,0.68,0.63636,147,0.432352941,
00.11.09,272,229,501,380,0.76,0.53158,202,0.403193613,
00.11.10,626,597,1223,716,0.59,0.47626,341,0.278822567,
00.11.11,1135,1112,2247,1342,0.6,0.65723,882,0.392523364,
00.11.12,312,296,608,384,0.63,0.54167,208,0.342105263,
00.11.13,789,756,1545,971,0.63,0.6035,586,0.379288026,
00.11.14,1004,1008,2012,1502,0.75,0.70706,1062,0.527833002,
00.11.15,52,45,97,75,0.77,0.73333,55,0.567010309,
00.11.16,424,383,807,563,0.7,0.65897,371,0.459727385,
00.11.17,1109,1166,2275,1334,0.59,0.6027,804,0.353406593,
00.11.18,374,384,758,541,0.71,0.68207,369,0.486807388,
00.11.19,331,367,698,555,0.8,0.79459,441,0.631805158,
00.11.20,612,589,1201,764,0.64,0.64529,493,0.410491257,
00.11.21,596,637,1233,746,0.61,0.7185,536,0.434712084,
00.11.22,152,177,329,268,0.81,0.82836,222,0.674772036,
00.11.23,420,461,881,604,0.69,0.67053,405,0.459704881,
00.11.24,604,562,1166,895,0.77,0.73296,656,0.562607204,
00.11.25,233,240,473,350,0.74,0.69143,242,0.511627907,
00.11.26,185,192,377,293,0.78,0.72696,213,0.564986737,
00.11.27,328,323,651,449,0.69,0.81069,364,0.559139785,
00.11.28,579,616,1195,344,0.29,0.63372,218,0.182426778,
00.11.29,567,600,1167,356,0.31,0.69382,247,0.211653813,
00.11.30,548,561,1109,457,0.41,0.76805,351,0.316501353,
00.11.31,572,612,1184,445,0.38,0.76629,341,0.288006757,
00.11.32,604,648,1252,547,0.44,0.84461,462,0.369009585,
00.11.33,447,483,930,348,0.37,0.73851,257,0.276344086,
00.11.34,696,754,1450,449,0.31,0.65924,296,0.204137931,
00.11.35,687,758,1445,478,0.33,0.72385,346,0.239446367,
00.11.36,686,735,1421,406,0.29,0.70443,286,0.201266714,
00.11.37,556,562,1118,328,0.29,0.71951,236,0.211091234,
00.11.38,785,818,1603,466,0.29,0.63305,295,0.184029944,
00.11.39,763,796,1559,489,0.31,0.61963,303,0.194355356,
00.11.40,511,564,1075,410,0.38,0.6561,269,0.250232558,
00.12.01,655,521,1176,771,0.66,0.54215,418,0.355442177,
00.12.02,1149,978,2127,1321,0.62,0.5564,735,0.345557123,
00.12.03,1063,896,1959,1209,0.62,0.50951,616,0.314446146,
00.12.04,756,604,1360,815,0.6,0.59877,488,0.358823529,
00.12.05,516,443,959,606,0.63,0.58251,353,0.368091762,
00.12.06,784,748,1532,1035,0.68,0.64928,672,0.438642298,
00.12.07,949,960,1909,1190,0.62,0.6521,776,0.406495547,
00.12.08,1042,1064,2106,1271,0.6,0.63651,809,0.384140551,
00.12.09,702,664,1366,735,0.54,0.51565,379,0.277452416,
00.12.10,686,673,1359,799,0.59,0.5632,450,0.331125828,
00.12.11,440,408,848,626,0.74,0.59744,374,0.441037736,
00.12.12,183,176,359,251,0.7,0.62151,156,0.43454039,
00.12.13,37,42,79,55,0.7,0.6,33,0.417721519,
00.12.14,720,656,1376,884,0.64,0.64027,566,0.411337209,
00.12.15,643,649,1292,758,0.59,0.64248,487,0.376934985,
00.12.16,693,656,1349,827,0.61,0.67594,559,0.414381023,
00.12.17,627,593,1220,784,0.64,0.69643,546,0.447540984,
00.12.18,533,492,1025,639,0.62,0.65102,416,0.405853659,
00.12.19,376,388,764,575,0.75,0.57217,329,0.430628272,
00.12.20,643,672,1315,835,0.63,0.62036,518,0.39391635,
00.12.21,576,537,1113,719,0.65,0.61752,444,0.398921833,
00.12.22,129,111,240,132,0.55,0.85606,113,0.470833333,
00.12.23,1161,1049,2210,1441,0.65,0.65094,938,0.424434389,
00.12.24,535,508,1043,698,0.67,0.61032,426,0.4084372,
00.12.25,766,759,1525,1053,0.69,0.5831,614,0.402622951,
00.12.26,441,498,939,639,0.68,0.67919,434,0.462193823,
00.12.27,690,673,1363,885,0.65,0.63164,559,0.410124725,
00.12.28,716,677,1393,879,0.63,0.62799,552,0.39626705,
00.12.29,481,488,969,691,0.71,0.76845,531,0.547987616,
00.12.30,694,614,1308,907,0.69,0.58875,534,0.408256881,
00.12.31,499,488,987,648,0.66,0.66667,432,0.43768997,
00.12.32,606,580,1186,737,0.62,0.63908,471,0.397133221,
00.12.33,642,644,1286,738,0.57,0.58672,433,0.336702955,
00.12.34,521,527,1048,627,0.6,0.6236,391,0.373091603,
00.12.35,375,367,742,524,0.71,0.56489,296,0.398921833,
00.12.36,517,514,1031,733,0.71,0.7176,526,0.510184287,
00.12.37,589,522,1111,759,0.68,0.53887,409,0.368136814,
00.12.38,378,356,734,536,0.73,0.58769,315,0.429155313,
00.12.39,320,305,625,439,0.7,0.57859,254,0.4064,
00.12.40,560,546,1106,716,0.65,0.67318,482,0.435804702,
00.12.41,221,216,437,331,0.76,0.69184,229,0.52402746,
00.12.42,553,584,1137,882,0.78,0.72449,639,0.562005277,
00.12.43,215,239,454,346,0.76,0.71387,247,0.544052863,
00.12.44,190,193,383,294,0.77,0.65306,192,0.501305483,
00.13.01,861,733,1594,1048,0.66,0.53435,560,0.35131744,
00.13.02,901,896,1797,1054,0.59,0.61954,653,0.363383417,
00.13.03,896,904,1800,1208,0.67,0.625,755,0.419444444,
00.13.04,482,501,983,562,0.57,0.59075,332,0.337741607,
00.13.05,1049,953,2002,1202,0.6,0.57404,690,0.344655345,
00.13.06,993,884,1877,1051,0.56,0.6156,647,0.344698988,
00.13.07,632,567,1199,757,0.63,0.59313,449,0.374478732,
00.13.08,630,604,1234,792,0.64,0.58081,460,0.372771475,
00.13.09,625,611,1236,763,0.62,0.57798,441,0.356796117,
00.13.10,651,624,1275,811,0.64,0.63748,517,0.405490196,
00.13.11,975,958,1933,1319,0.68,0.62244,821,0.424728401,
00.13.12,115,125,240,160,0.67,0.63125,101,0.420833333,
00.13.13,852,779,1631,1074,0.66,0.60428,649,0.397915389,
00.13.14,350,334,684,424,0.62,0.57311,243,0.355263158,
00.13.15,157,142,299,213,0.71,0.83568,178,0.595317726,
00.13.16,107,83,190,170,0.89,0.61176,104,0.547368421,
00.13.17,380,400,780,573,0.73,0.71379,409,0.524358974,
00.13.18,307,262,569,398,0.7,0.72362,288,0.506151142,
00.13.19,750,667,1417,1032,0.73,0.59593,615,0.434015526,
00.13.20,325,285,610,444,0.73,0.64189,285,0.467213115,
00.13.21,276,212,488,357,0.73,0.73389,262,0.536885246,
00.13.22,128,110,238,171,0.72,0.64327,110,0.462184874,
00.13.23,683,705,1388,966,0.7,0.7381,713,0.513688761,
00.13.24,263,233,496,340,0.69,0.63235,215,0.433467742,
00.13.25,956,1033,1989,1213,0.61,0.67519,819,0.411764706,
00.14.01,716,553,1269,774,0.61,0.62403,483,0.380614657,
00.14.02,1149,964,2113,1263,0.6,0.64608,816,0.386180786,
00.14.03,665,563,1228,809,0.66,0.67367,545,0.443811075,
00.14.04,631,561,1192,744,0.62,0.63172,470,0.394295302,
00.14.05,421,425,846,583,0.69,0.58662,342,0.404255319,
00.14.06,457,437,894,609,0.68,0.55172,336,0.375838926,
00.14.07,239,191,430,334,0.78,0.77844,260,0.604651163,
00.14.08,536,510,1046,686,0.66,0.62536,429,0.410133843,
00.14.09,421,394,815,569,0.7,0.66432,378,0.463803681,
00.14.10,528,485,1013,559,0.55,0.66726,373,0.368213228,
00.14.11,996,861,1857,1072,0.58,0.7584,813,0.437802908,
00.14.12,874,811,1685,1122,0.67,0.6738,756,0.448664688,
00.14.13,477,489,966,518,0.54,0.66988,347,0.359213251,
00.14.14,428,379,807,437,0.54,0.62014,271,0.335811648,
00.14.15,491,486,977,558,0.57,0.65591,366,0.374616172,
00.14.16,255,277,532,301,0.57,0.701,211,0.396616541,
00.14.17,363,406,769,445,0.58,0.77753,346,0.44993498,
00.14.18,527,559,1086,616,0.57,0.5763,355,0.326887661,
00.14.19,235,248,483,327,0.68,0.66361,217,0.449275362,
00.14.20,171,173,344,247,0.72,0.90688,224,0.651162791,
00.15.01,752,649,1401,826,0.59,0.67797,560,0.39971449,
00.15.02,729,560,1289,776,0.6,0.56701,440,0.341349884,
00.15.03,357,342,699,493,0.71,0.61866,305,0.436337625,
00.15.04,898,849,1747,1037,0.59,0.59499,617,0.353176875,
00.15.05,922,960,1882,1084,0.58,0.51107,554,0.294367694,
00.15.06,877,870,1747,1115,0.64,0.59731,666,0.381224957,
00.15.07,366,360,726,477,0.66,0.59539,284,0.391184573,
00.15.08,631,591,1222,846,0.69,0.6253,529,0.43289689,
00.15.09,412,407,819,425,0.52,0.61412,261,0.318681319,
00.15.10,255,259,514,340,0.66,0.67353,229,0.445525292,
00.15.11,468,547,1015,647,0.64,0.66924,433,0.426600985,
00.15.12,1272,1344,2616,1504,0.57,0.64827,975,0.372706422,
00.15.13,689,725,1414,876,0.62,0.57648,505,0.357142857,
00.15.14,338,341,679,440,0.65,0.58182,256,0.377025037,
00.15.15,839,839,1678,475,0.28,0.70105,333,0.198450536,
00.15.16,1189,1279,2468,960,0.39,0.69583,668,0.270664506,
00.15.17,974,953,1927,673,0.35,0.70282,473,0.245459263,
00.15.18,1115,1067,2182,635,0.29,0.72126,458,0.209899175,
00.15.19,720,694,1414,538,0.38,0.671,361,0.255304102,
00.15.20,153,163,316,172,0.54,0.86628,149,0.471518987,
00.15.21,416,388,804,558,0.69,0.66487,371,0.461442786,
00.15.22,760,815,1575,972,0.62,0.60288,586,0.372063492,
00.15.23,662,656,1318,878,0.67,0.63554,558,0.423368741,
00.15.24,252,221,473,346,0.73,0.54913,190,0.401691332,
00.15.25,346,399,745,493,0.66,0.70791,349,0.468456376,
00.15.26,363,354,717,466,0.65,0.69957,326,0.454672245,
00.15.27,400,441,841,544,0.65,0.58456,318,0.378121284,
00.15.28,421,472,893,593,0.66,0.61214,363,0.406494961,
00.15.29,200,195,395,254,0.64,0.65748,167,0.42278481,
00.15.30,695,596,1291,773,0.6,0.53558,414,0.320681642,
00.15.31,848,694,1542,914,0.59,0.5186,474,0.307392996,
00.16.01,655,612,1267,799,0.63,0.48561,388,0.306235201,
00.16.02,659,621,1280,835,0.65,0.5988,500,0.390625,
00.16.03,592,547,1139,724,0.64,0.49448,358,0.314310799,
00.16.04,670,590,1260,825,0.65,0.53212,439,0.348412698,
00.16.05,630,556,1186,765,0.65,0.51634,395,0.333052277,
00.16.06,726,605,1331,765,0.57,0.44706,342,0.256949662,
00.16.07,339,336,675,449,0.67,0.6147,276,0.408888889,
00.16.08,331,309,640,413,0.65,0.75787,313,0.4890625,
00.16.09,716,704,1420,861,0.61,0.54472,469,0.33028169,
00.16.10,727,701,1428,837,0.59,0.6583,551,0.385854342,
00.16.11,592,596,1188,680,0.57,0.56912,387,0.325757576,
00.16.12,147,123,270,249,0.92,0.82329,205,0.759259259,
00.16.13,214,103,317,188,0.59,0.74468,140,0.441640379,
00.16.14,134,149,283,184,0.65,0.5163,95,0.335689046,
00.16.15,870,890,1760,1056,0.6,0.41098,434,0.246590909,
00.16.16,232,186,418,318,0.76,0.92767,295,0.705741627,
00.16.17,188,169,357,183,0.51,0.56831,104,0.291316527,
00.16.18,220,216,436,300,0.69,0.61,183,0.419724771,
00.16.19,385,387,772,461,0.6,0.56182,259,0.335492228,
00.16.20,720,759,1479,964,0.65,0.5778,557,0.376605815,
00.16.21,508,511,1019,700,0.69,0.65857,461,0.452404318,
00.16.22,699,643,1342,800,0.6,0.56125,449,0.334575261,
00.16.23,562,574,1136,716,0.63,0.53073,380,0.334507042,
00.16.24,555,593,1148,742,0.65,0.54582,405,0.352787456,
00.16.25,626,623,1249,823,0.66,0.56987,469,0.3755004,
00.16.26,530,537,1067,654,0.61,0.56881,372,0.34864105,
00.16.27,218,231,449,277,0.62,0.54874,152,0.338530067,
00.16.28,358,382,740,441,0.6,0.70068,309,0.417567568,
00.16.29,128,153,281,227,0.81,0.72247,164,0.583629893,
00.17.01,791,638,1429,944,0.66,0.52648,497,0.347795661,
00.17.02,707,533,1240,786,0.63,0.48982,385,0.310483871,
00.17.03,502,399,901,619,0.69,0.59612,369,0.40954495,
00.17.04,722,625,1347,817,0.61,0.46267,378,0.280623608,
00.17.05,935,701,1636,1002,0.61,0.49501,496,0.303178484,
00.17.06,1315,1001,2316,1335,0.58,0.49288,658,0.284110535,
00.17.07,1079,873,1952,1184,0.61,0.4924,583,0.298668033,
00.17.08,867,605,1472,917,0.62,0.49182,451,0.30638587,
00.17.09,1376,915,2291,1316,0.57,0.4734,623,0.271933653,
00.17.10,808,665,1473,867,0.59,0.391,339,0.230142566,
00.17.11,644,452,1096,670,0.61,0.50448,338,0.308394161,
00.17.12,822,698,1520,963,0.63,0.43614,420,0.276315789,
00.17.13,796,814,1610,971,0.6,0.57467,558,0.346583851,
00.17.14,428,405,833,582,0.7,0.59622,347,0.416566627,
00.17.15,475,448,923,653,0.71,0.63093,412,0.446370531,
00.17.16,574,547,1121,672,0.6,0.59375,399,0.355932203,
00.17.17,490,474,964,625,0.65,0.5792,362,0.375518672,
00.17.18,743,664,1407,926,0.66,0.50324,466,0.331201137,
00.17.19,911,939,1850,1082,0.58,0.63124,683,0.369189189,
00.17.20,878,821,1699,1083,0.64,0.54109,586,0.34490877,
00.17.21,237,218,455,296,0.65,0.69595,206,0.452747253,
00.17.22,994,876,1870,1190,0.64,0.52773,628,0.335828877,
00.17.23,1018,941,1959,1217,0.62,0.44289,539,0.275140378,
00.17.24,697,635,1332,833,0.63,0.41297,344,0.258258258,
00.17.25,161,145,306,183,0.6,0.59563,109,0.35620915,
00.17.26,471,470,941,668,0.71,0.51198,342,0.363443146,
00.17.27,591,590,1181,770,0.65,0.53506,412,0.348856901,
00.17.28,601,575,1176,775,0.66,0.53548,415,0.352891156,
00.17.29,776,768,1544,623,0.4,0.86517,539,0.349093264,
00.17.30,851,770,1621,582,0.36,0.86942,506,0.312152992,
00.17.31,938,808,1746,529,0.3,0.85822,454,0.26002291,
00.17.32,868,823,1691,642,0.38,0.91121,585,0.345949143,
00.17.33,1155,1121,2276,1433,0.63,0.55967,802,0.352372583,
00.17.34,914,914,1828,1217,0.67,0.5415,659,0.360503282,
00.17.35,404,409,813,507,0.62,0.53649,272,0.334563346,
00.17.36,534,478,1012,587,0.58,0.523,307,0.303359684,
00.17.37,318,310,628,347,0.55,0.6196,215,0.342356688,
00.17.38,344,324,668,473,0.71,0.60254,285,0.426646707,
00.17.39,376,408,784,480,0.61,0.575,276,0.352040816,
00.17.40,53,36,89,70,0.79,0.8,56,0.629213483,
00.17.41,731,735,1466,858,0.59,0.50932,437,0.298090041,
00.17.42,51,55,106,68,0.64,0.58824,40,0.377358491,
00.17.43,247,231,478,306,0.64,0.43791,134,0.280334728,
00.18.01,768,665,1433,925,0.65,0.60324,558,0.389392882,
00.18.02,795,653,1448,783,0.54,0.58621,459,0.31698895,
00.18.03,1234,1097,2331,1268,0.54,0.59621,756,0.324324324,
00.18.04,1258,1105,2363,879,0.37,0.79977,703,0.297503174,
00.18.05,1154,1076,2230,1143,0.51,0.44094,504,0.226008969,
00.18.06,613,530,1143,568,0.5,0.39437,224,0.195975503,
00.18.07,263,204,467,222,0.48,0.73874,164,0.35117773,
00.18.08,660,631,1291,752,0.58,0.56117,422,0.326878389,
00.18.09,145,145,290,127,0.44,0.67717,86,0.296551724,
00.18.10,676,727,1403,806,0.57,0.48139,388,0.276550249,
00.18.11,618,594,1212,663,0.55,0.51282,340,0.280528053,
00.18.12,401,402,803,478,0.6,0.62762,300,0.373599004,
00.18.13,102,186,288,182,0.63,0.58242,106,0.368055556,
00.18.14,498,513,1011,633,0.63,0.59242,375,0.370919881,
00.18.15,167,196,363,254,0.7,0.63386,161,0.443526171,
00.18.16,559,522,1081,576,0.53,0.71007,409,0.378353377,
00.18.17,1301,1169,2470,1308,0.53,0.41667,545,0.220647773,
00.18.18,1032,956,1988,1064,0.54,0.51692,550,0.27665996,
00.18.19,246,242,488,280,0.57,0.65,182,0.37295082,
00.18.20,120,158,278,181,0.65,0.65746,119,0.428057554,
00.18.21,715,655,1370,568,0.41,0.72359,411,0.3,
00.18.22,453,395,848,330,0.39,0.68182,225,0.265330189,
00.18.23,771,675,1446,773,0.53,0.52135,403,0.278699862,
00.18.24,714,727,1441,837,0.58,0.45998,385,0.267175573,
00.19.01,602,533,1135,617,0.54,0.54619,337,0.2969163,
00.19.02,595,540,1135,657,0.58,0.55708,366,0.32246696,
00.19.03,228,200,428,301,0.7,0.57475,173,0.404205607,
00.19.04,124,124,248,156,0.63,0.60897,95,0.383064516,
00.19.05,132,141,273,149,0.55,0.49664,74,0.271062271,
00.19.06,94,87,181,125,0.69,0.592,74,0.408839779,
00.19.07,43,64,107,77,0.72,0.74026,57,0.53271028,
00.19.08,284,265,549,343,0.62,0.55394,190,0.346083789,
00.19.09,299,323,622,312,0.5,0.55769,174,0.279742765,
00.19.10,101,119,220,131,0.6,0.59542,78,0.354545455,
00.19.11,355,422,777,461,0.59,0.62256,287,0.369369369,
00.19.12,440,441,881,507,0.58,0.57002,289,0.328036322,
00.19.13,149,144,293,228,0.78,0.85965,196,0.66894198,
00.19.14,141,185,326,203,0.62,0.82266,167,0.512269939,
00.19.15,179,194,373,246,0.66,0.69106,170,0.455764075,
00.19.16,292,267,559,314,0.56,0.6879,216,0.386404293,
00.19.17,363,386,749,502,0.67,0.61753,310,0.41388518,
00.19.18,117,119,236,138,0.58,0.58696,81,0.343220339,
00.19.19,385,390,775,536,0.69,0.70896,380,0.490322581,
00.19.20,512,418,930,522,0.56,0.61303,320,0.344086022,
00.20.01,1081,902,1983,1265,0.64,0.43004,544,0.27433182,
00.20.02,696,691,1387,713,0.51,0.47546,339,0.244412401,
00.20.03,895,717,1612,955,0.59,0.43037,411,0.254962779,
00.20.04,1179,953,2132,1325,0.62,0.41811,554,0.259849906,
00.20.05,797,617,1414,917,0.65,0.42748,392,0.277227723,
00.20.06,775,644,1419,903,0.64,0.44075,398,0.280479211,
00.20.07,773,663,1436,895,0.62,0.42346,379,0.263927577,
00.20.08,759,601,1360,773,0.57,0.44761,346,0.254411765,
00.20.09,689,514,1203,768,0.64,0.42318,325,0.270157938,
00.20.10,1784,1381,3165,1620,0.51,0.3963,642,0.202843602,
00.20.11,1485,1128,2613,1478,0.57,0.42152,623,0.238423268,
00.20.12,950,750,1700,877,0.52,0.49943,438,0.257647059,
00.20.13,893,812,1705,936,0.55,0.47436,444,0.260410557,
00.20.14,893,772,1665,936,0.56,0.44338,415,0.249249249,
00.20.15,581,473,1054,627,0.59,0.35407,222,0.210626186,
00.20.16,1149,943,2092,1256,0.6,0.41959,527,0.251912046,
00.20.17,1089,945,2034,1154,0.57,0.44887,518,0.2546706,
00.20.18,713,536,1249,762,0.61,0.44094,336,0.269015212,
00.20.19,731,566,1297,778,0.6,0.44859,349,0.269082498,
00.20.20,739,604,1343,748,0.56,0.43182,323,0.240506329,
00.20.21,836,696,1532,902,0.59,0.43016,388,0.253263708,
00.20.22,732,561,1293,764,0.59,0.39136,299,0.231245166,
00.20.23,1242,972,2214,1235,0.56,0.38704,478,0.215898826,
00.20.24,1343,900,2243,1308,0.58,0.43502,569,0.25367811,
00.20.25,1435,1137,2572,1314,0.51,0.42161,554,0.215396579,
00.20.26,663,496,1159,662,0.57,0.42447,281,0.242450388,
00.20.27,784,617,1401,834,0.6,0.44844,374,0.266952177,
00.20.28,619,504,1123,639,0.57,0.40219,257,0.228851291,
00.20.29,1604,1357,2961,1634,0.55,0.35496,580,0.19587977,
00.20.30,1532,1273,2805,1511,0.54,0.41032,620,0.221033868,
00.20.31,1332,1098,2430,1326,0.55,0.37632,499,0.205349794,
00.20.32,657,568,1225,670,0.55,0.43731,293,0.239183673,
00.20.33,904,755,1659,862,0.52,0.39907,344,0.207353828,
00.20.34,1373,1110,2483,1296,0.52,0.40432,524,0.211035038,
00.20.35,1185,992,2177,1216,0.56,0.41694,507,0.232889297,
00.20.36,1414,1225,2639,1509,0.57,0.38834,586,0.222053808,
00.20.37,1330,1096,2426,1356,0.56,0.39971,542,0.223413026,
00.20.38,1462,1284,2746,1537,0.56,0.41314,635,0.231245448,
00.20.39,702,604,1306,762,0.58,0.4042,308,0.235834609,
00.20.40,1213,1059,2272,1325,0.58,0.3834,508,0.223591549,
00.20.41,509,440,949,619,0.65,0.40549,251,0.264488936,
00.20.42,815,629,1444,798,0.55,0.38722,309,0.21398892,
00.20.43,722,585,1307,786,0.6,0.42112,331,0.253251721,
00.20.44,712,589,1301,767,0.59,0.35724,274,0.210607225,
00.20.45,907,690,1597,852,0.53,0.37324,318,0.199123356,
00.20.46,1267,970,2237,1309,0.59,0.3919,513,0.229324989,
00.20.47,1290,991,2281,1267,0.56,0.42226,535,0.234546252,
00.20.48,1379,1132,2511,1456,0.58,0.35783,521,0.207487057,
00.20.49,1448,1163,2611,1478,0.57,0.39107,578,0.221371122,
00.20.50,1392,1149,2541,1295,0.51,0.37838,490,0.192837466,
00.20.51,1183,947,2130,1331,0.62,0.44553,593,0.278403756,
00.20.52,1348,1101,2449,1468,0.6,0.41144,604,0.246631278,
00.20.53,718,585,1303,715,0.55,0.33706,241,0.18495779,
00.20.54,689,581,1270,748,0.59,0.42246,316,0.248818898,
00.20.55,733,562,1295,754,0.58,0.36605,276,0.213127413,
00.20.56,1182,967,2149,1240,0.58,0.37984,471,0.219171708,
00.20.57,1346,1060,2406,1351,0.56,0.41007,554,0.230257689,
00.20.58,0,0,0,215,0,0.68837,148,0,
00.20.59,0,0,0,132,0,0.84091,111,0,
00.20.60,0,0,0,93,0,0.87097,81,0,
00.20.61,0,0,0,238,0,0.77311,184,0,
00.21.01,1398,1332,2730,823,0.3,0.72296,595,0.217948718,
00.21.02,1182,1108,2290,753,0.33,0.7251,546,0.238427948,
00.21.03,1326,988,2314,787,0.34,0.62008,488,0.210890233,
00.21.04,1481,1286,2767,927,0.34,0.56311,522,0.18865197,
00.21.05,1233,1115,2348,969,0.41,0.72343,701,0.298551959,
00.21.06,1172,972,2144,414,0.19,0.75362,312,0.145522388,
00.21.07,816,687,1503,363,0.24,0.83471,303,0.201596806,
00.21.08,698,648,1346,764,0.57,0.55366,423,0.314264487,
00.21.09,602,632,1234,857,0.69,0.72695,623,0.504862237,
00.21.10,233,214,447,298,0.67,0.67785,202,0.451901566,
00.21.11,106,93,199,151,0.76,0.6755,102,0.512562814,
00.21.12,95,85,180,76,0.42,0.47368,36,0.2,
00.21.13,575,538,1113,641,0.58,0.5429,348,0.312668464,
00.21.14,622,618,1240,733,0.59,0.54161,397,0.32016129,
00.21.15,829,742,1571,958,0.61,0.5167,495,0.315085933,
00.21.16,1148,1133,2281,968,0.42,0.81921,793,0.347654537,
00.21.17,737,749,1486,994,0.67,0.7002,696,0.468371467,
00.21.18,286,274,560,433,0.77,0.83603,362,0.646428571,
00.21.19,689,595,1284,371,0.29,0.74663,277,0.215732087,
00.21.20,1512,1269,2781,668,0.24,0.50898,340,0.122258181,
00.21.21,493,410,903,521,0.58,0.63724,332,0.367663344,
00.21.22,689,607,1296,707,0.55,0.58416,413,0.31867284,
00.21.23,156,153,309,170,0.55,0.61176,104,0.336569579,
00.21.24,776,705,1481,808,0.55,0.73762,596,0.40243079,
00.21.25,556,560,1116,748,0.67,0.7607,569,0.509856631,
00.21.26,468,437,905,602,0.67,0.7093,427,0.471823204,
00.21.27,708,748,1456,943,0.65,0.71474,674,0.462912088,
00.21.28,361,350,711,425,0.6,0.66353,282,0.396624473,
00.21.29,641,646,1287,785,0.61,0.72739,571,0.443667444,
00.21.30,91,99,190,120,0.63,0.61667,74,0.389473684,
00.21.31,469,420,889,486,0.55,0.54527,265,0.298087739,
00.21.32,1178,990,2168,602,0.28,0.80731,486,0.224169742,
00.21.33,679,779,1458,603,0.41,0.79768,481,0.329903978,
00.21.34,669,695,1364,879,0.64,0.6587,579,0.424486804,
00.21.35,677,679,1356,796,0.59,0.61809,492,0.362831858,
00.21.36,35,44,79,62,0.78,0.70968,44,0.556962025,
00.21.37,564,599,1163,735,0.63,0.62721,461,0.39638865,
00.21.38,608,601,1209,759,0.63,0.64559,490,0.405293631,
00.21.39,769,778,1547,1001,0.65,0.65335,654,0.422753717,
00.21.40,515,518,1033,552,0.53,0.68478,378,0.365924492,
00.21.41,872,829,1701,529,0.31,0.74858,396,0.232804233,
00.21.42,933,869,1802,527,0.29,0.6926,365,0.202552719,
00.21.43,1203,1057,2260,544,0.24,0.69669,379,0.167699115,
00.21.44,1324,1325,2649,797,0.3,0.69887,557,0.210268026,
00.21.45,1050,1078,2128,641,0.3,0.79251,508,0.238721805,
00.21.46,769,751,1520,980,0.64,0.66429,651,0.428289474,
00.21.47,906,870,1776,788,0.44,0.63452,500,0.281531532,
00.21.48,522,537,1059,511,0.48,0.6771,346,0.326723324,
00.21.49,479,445,924,399,0.43,0.75689,302,0.326839827,
00.21.50,511,470,981,424,0.43,0.75,318,0.324159021,
00.21.51,571,513,1084,464,0.43,0.82974,385,0.355166052,
00.21.52,774,523,1297,585,0.45,0.55043,322,0.248265227,
00.21.53,631,720,1351,584,0.43,0.82534,482,0.356772761,
00.22.01,1419,1302,2721,931,0.34,0.74758,696,0.255788313,
00.22.02,1323,1153,2476,807,0.33,0.65923,532,0.214862682,
00.22.03,1521,1333,2854,1064,0.37,0.7641,813,0.28486335,
00.22.04,1447,1172,2619,878,0.34,0.7164,629,0.240168003,
00.22.05,716,658,1374,580,0.42,0.78448,455,0.331149927,
00.22.06,884,884,1768,483,0.27,0.7619,368,0.208144796,
00.22.07,1413,1414,2827,1121,0.4,0.8314,932,0.329678104,
00.22.08,734,717,1451,988,0.68,0.95243,941,0.648518263,
00.22.09,413,372,785,324,0.41,0.94136,305,0.388535032,
00.22.10,1070,1029,2099,795,0.38,0.87799,698,0.332539304,
00.22.11,161,153,314,156,0.5,0.64103,100,0.318471338,
00.22.12,1459,1499,2958,1105,0.37,0.92217,1019,0.34448952,
00.22.13,866,942,1808,622,0.34,0.64952,404,0.223451327,
00.22.14,1255,1190,2445,871,0.36,0.80482,701,0.286707566,
00.22.15,720,738,1458,435,0.3,0.82529,359,0.246227709,
00.22.16,753,792,1545,526,0.34,0.81749,430,0.278317152,
00.22.17,647,596,1243,427,0.34,0.82201,351,0.282381335,
00.22.18,855,845,1700,903,0.53,0.90033,813,0.478235294,
00.22.19,359,370,729,355,0.49,0.87887,312,0.427983539,
00.22.20,113,135,248,142,0.57,0.73944,105,0.423387097,
00.22.21,624,599,1223,804,0.66,0.72637,584,0.477514309,
00.22.22,579,587,1166,655,0.56,0.85802,562,0.481989708,
00.22.23,619,630,1249,396,0.32,0.61616,244,0.195356285,
00.22.24,371,406,777,398,0.51,0.68844,274,0.352638353,
00.22.25,570,584,1154,444,0.38,0.62162,276,0.239168111,
00.22.26,778,739,1517,857,0.56,0.64877,556,0.366512854,
00.22.27,520,594,1114,765,0.69,0.76732,587,0.526929982,
00.22.28,643,655,1298,618,0.48,0.73139,452,0.348228043,
00.22.29,795,802,1597,955,0.6,0.80419,768,0.480901691,
00.22.30,696,711,1407,691,0.49,0.78726,544,0.386638237,
00.22.31,812,805,1617,1095,0.68,0.76621,839,0.51886209,
00.22.32,531,524,1055,611,0.58,0.64321,393,0.372511848,
00.22.33,273,270,543,369,0.68,0.80759,298,0.548802947,
00.22.34,558,511,1069,450,0.42,0.87778,395,0.36950421,
00.22.35,670,542,1212,362,0.3,0.79006,286,0.235973597,
00.22.36,662,621,1283,350,0.27,0.78286,274,0.213561964,
00.22.37,743,832,1575,599,0.38,0.80634,483,0.306666667,
00.22.38,615,656,1271,514,0.4,0.85992,442,0.347757671,
00.22.39,466,516,982,411,0.42,0.87105,358,0.364562118,
00.22.40,716,687,1403,593,0.42,0.90725,538,0.383464006,
00.22.41,819,771,1590,463,0.29,0.76674,355,0.22327044,
00.22.42,645,571,1216,718,0.59,0.86072,618,0.508223684,
00.22.43,644,601,1245,436,0.35,0.74771,326,0.26184739,
00.22.44,764,758,1522,635,0.42,0.83465,530,0.348226018,
00.22.45,171,175,346,179,0.52,0.82123,147,0.424855491,
00.22.46,493,531,1024,385,0.38,0.68571,264,0.2578125,
00.22.47,529,482,1011,412,0.41,0.6699,276,0.272997033,
00.22.48,745,766,1511,538,0.36,0.79554,428,0.283256122,
00.22.49,793,813,1606,559,0.35,0.89267,499,0.310709838,
00.22.50,766,722,1488,450,0.3,0.79778,359,0.241263441,
00.22.51,480,477,957,366,0.38,0.7377,270,0.282131661,
00.22.52,608,610,1218,419,0.34,0.78282,328,0.269293924,
00.22.53,553,524,1077,511,0.47,0.91389,467,0.433611885,
00.22.54,427,445,872,383,0.44,0.7389,283,0.324541284,
00.22.55,723,716,1439,554,0.38,0.62635,347,0.24113968,
00.22.56,670,678,1348,460,0.34,0.85217,392,0.290801187,
00.22.57,480,492,972,409,0.42,0.73105,299,0.307613169,
00.22.58,722,713,1435,457,0.32,0.78337,358,0.249477352,
00.22.59,618,640,1258,577,0.46,0.83362,481,0.382352941,
00.22.60,228,209,437,333,0.76,0.87688,292,0.66819222,
00.22.61,327,292,619,503,0.81,0.93638,471,0.760904685,
00.22.62,247,239,486,245,0.5,0.73061,179,0.368312757,
00.22.63,67,85,152,126,0.83,0.92857,117,0.769736842,
00.22.64,299,308,607,409,0.67,0.82885,339,0.558484349,
00.22.65,250,262,512,293,0.57,0.77474,227,0.443359375,
00.22.66,595,649,1244,636,0.51,0.80189,510,0.409967846,
00.22.67,550,544,1094,392,0.36,0.57653,226,0.206581353,
00.22.68,95,94,189,178,0.94,0.94382,168,0.888888889,
00.22.69,778,865,1643,0,0,0,0,0,
00.22.70,408,454,862,741,0.86,0.73549,545,0.63225058,
00.22.71,563,582,1145,809,0.71,0.86527,700,0.611353712,
00.22.72,437,456,893,320,0.36,0.86875,278,0.31131019,
00.22.73,606,549,1155,440,0.38,0.7,308,0.266666667,
00.22.74,700,683,1383,690,0.5,0.87536,604,0.436731743,
00.22.75,508,487,995,385,0.39,0.78182,301,0.302512563,
00.22.76,451,352,803,325,0.4,0.77846,253,0.315068493,
00.22.77,271,226,497,292,0.59,0.89041,260,0.523138833,
00.22.78,83,83,166,119,0.72,0.90756,108,0.65060241,
00.22.79,700,697,1397,538,0.39,0.84758,456,0.326413744,
00.22.80,503,538,1041,441,0.42,0.8254,364,0.349663785,
00.22.81,579,604,1183,622,0.53,0.87621,545,0.460693153,
00.23.01,1062,958,2020,1239,0.61,0.68281,846,0.418811881,
00.23.02,1343,1174,2517,1500,0.6,0.682,1023,0.406436234,
00.23.03,1389,1269,2658,1605,0.6,0.7134,1145,0.430775019,
00.23.04,650,590,1240,748,0.6,0.72059,539,0.434677419,
00.23.05,150,164,314,225,0.72,0.67111,151,0.48089172,
00.23.06,294,276,570,391,0.69,0.80818,316,0.554385965,
00.23.07,81,96,177,106,0.6,0.93396,99,0.559322034,
00.23.08,546,596,1142,475,0.42,0.74105,352,0.308231173,
00.23.09,308,344,652,369,0.57,0.79675,294,0.450920245,
00.23.10,1352,1369,2721,1168,0.43,0.96147,1123,0.412715913,
00.23.11,601,628,1229,577,0.47,0.94801,547,0.445077299,
00.23.12,926,1009,1935,744,0.38,0.90726,675,0.348837209,
00.23.13,322,275,597,225,0.38,0.74222,167,0.279731993,
00.23.14,429,432,861,397,0.46,0.80353,319,0.370499419,
00.23.15,232,257,489,182,0.37,0.82418,150,0.306748466,
00.23.16,146,162,308,206,0.67,0.78155,161,0.522727273,
00.23.17,605,619,1224,496,0.41,0.88911,441,0.360294118,
00.23.18,253,250,503,203,0.4,0.75369,153,0.30417495,
00.23.19,731,698,1429,609,0.43,0.9064,552,0.386284115,
00.23.20,390,385,775,401,0.52,0.95511,383,0.494193548,
00.23.21,323,306,629,324,0.52,0.8642,280,0.445151033,
00.23.22,901,964,1865,652,0.35,0.95245,621,0.332975871,
00.23.23,1414,1291,2705,987,0.36,0.76393,754,0.278743068,
00.23.24,1406,1302,2708,1043,0.39,0.8303,866,0.319793205,
00.23.25,237,238,475,194,0.41,0.76289,148,0.311578947,
00.23.26,1564,1472,3036,764,0.25,0.83901,641,0.21113307,
00.23.27,1193,1130,2323,579,0.25,0.84629,490,0.210934137,
00.23.28,686,656,1342,593,0.44,0.90556,537,0.400149031,
00.23.29,210,229,439,134,0.31,0.57463,77,0.175398633,
00.23.30,165,160,325,170,0.52,0.79412,135,0.415384615,
00.23.31,126,131,257,123,0.48,0.79675,98,0.381322957,
00.23.32,589,656,1245,846,0.68,0.75768,641,0.514859438,
00.23.33,421,434,855,371,0.43,0.95148,353,0.412865497,
00.23.34,519,580,1099,508,0.46,0.85236,433,0.39399454,
00.23.35,159,189,348,262,0.75,0.78244,205,0.58908046,
00.23.36,306,324,630,209,0.33,0.83254,174,0.276190476,
00.23.37,139,132,271,173,0.64,0.92486,160,0.590405904,
00.23.38,755,661,1416,859,0.61,0.78463,674,0.475988701,
00.23.39,748,683,1431,892,0.62,0.8139,726,0.507337526,
00.23.40,744,669,1413,818,0.58,0.8154,667,0.472045294,
00.23.41,457,449,906,674,0.74,0.83234,561,0.619205298,
00.23.42,660,710,1370,570,0.42,0.94561,539,0.393430657,
00.23.43,340,346,686,172,0.25,0.78488,135,0.196793003,
00.23.44,221,225,446,268,0.6,0.76866,206,0.461883408,
00.23.45,111,112,223,117,0.52,0.94017,110,0.493273543,
00.23.46,63,70,133,77,0.58,0.83117,64,0.481203008,
00.23.47,256,261,517,157,0.3,0.65605,103,0.199226306,
00.23.48,291,293,584,266,0.46,0.86842,231,0.395547945,
00.23.49,127,120,247,79,0.32,0.92405,73,0.295546559,
00.23.50,190,181,371,146,0.39,0.74658,109,0.293800539,
00.23.51,632,735,1367,345,0.25,0.82609,285,0.208485735,
00.23.52,640,678,1318,340,0.26,0.86765,295,0.223823976,
00.24.01,572,515,1087,648,0.6,0.7284,472,0.434222631,
00.24.02,668,594,1262,758,0.6,0.65963,500,0.396196513,
00.24.03,301,332,633,302,0.48,0.95033,287,0.453396524,
00.24.04,698,662,1360,663,0.49,0.87934,583,0.428676471,
00.24.05,312,382,694,226,0.33,0.73451,166,0.239193084,
00.24.06,30,56,86,35,0.41,0.91429,32,0.372093023,
00.24.07,256,257,513,188,0.37,0.81383,153,0.298245614,
00.24.08,311,346,657,471,0.72,0.70488,332,0.505327245,
00.24.09,225,257,482,331,0.69,0.63142,209,0.433609959,
00.24.10,209,242,451,263,0.58,0.76046,200,0.44345898,
00.24.11,28,46,74,55,0.74,0.67273,37,0.5,
00.24.12,324,387,711,508,0.71,0.6752,343,0.482419128,
00.24.13,85,88,173,117,0.68,0.58974,69,0.398843931,
00.24.14,142,130,272,112,0.41,0.78571,88,0.323529412,
00.24.15,111,99,210,92,0.44,0.8913,82,0.39047619,
00.24.16,229,265,494,374,0.76,0.69786,261,0.528340081,
00.24.17,316,354,670,493,0.74,0.63895,315,0.470149254,
00.24.18,60,67,127,112,0.88,0.74107,83,0.653543307,
00.24.19,225,234,459,268,0.58,0.97388,261,0.568627451,
00.24.20,211,202,413,243,0.59,0.83539,203,0.491525424,
00.24.21,170,171,341,148,0.43,0.83108,123,0.360703812,
00.24.22,572,613,1185,621,0.52,0.66023,410,0.345991561,
00.24.23,56,45,101,56,0.55,0.60714,34,0.336633663,
00.24.24,388,369,757,353,0.47,0.64873,229,0.302509908,
00.24.25,147,169,316,122,0.39,0.68033,83,0.262658228,
00.24.26,199,182,381,177,0.46,0.86441,153,0.401574803,
00.24.27,7,22,29,36,1.24,0.83333,30,1.034482759,
00.24.28,209,204,413,163,0.39,0.88344,144,0.348668281,
00.24.29,330,367,697,292,0.42,0.69178,202,0.289813486,
00.24.30,72,91,163,63,0.39,0.69841,44,0.26993865,
00.24.31,150,148,298,51,0.17,0.7451,38,0.127516779,
00.24.32,321,360,681,562,0.83,0.85943,483,0.709251101,
00.24.33,17,20,37,32,0.86,0.6875,22,0.594594595,
00.24.34,13,10,23,28,1.22,0.82143,23,1,
00.24.35,131,102,233,131,0.56,0.74046,97,0.416309013,
00.24.36,126,128,254,124,0.49,0.79032,98,0.385826772,
00.24.37,117,144,261,150,0.57,0.92667,139,0.53256705,
00.24.38,248,227,475,206,0.43,0.8835,182,0.383157895,
00.24.39,353,348,701,323,0.46,0.82663,267,0.380884451,
00.24.40,93,99,192,116,0.6,0.93103,108,0.5625,
00.24.41,26,30,56,51,0.91,0.76471,39,0.696428571,
00.24.42,128,157,285,152,0.53,0.55263,84,0.294736842,
00.24.43,554,587,1141,482,0.42,0.6888,332,0.290972831,
00.24.44,165,136,301,118,0.39,0.83051,98,0.325581395,
00.24.45,152,146,298,146,0.49,0.77397,113,0.379194631,
00.24.46,231,217,448,154,0.34,0.72727,112,0.25,
00.24.47,177,157,334,190,0.57,0.78947,150,0.449101796,
00.24.48,327,292,619,430,0.69,0.84884,365,0.589660743,
00.24.49,148,174,322,232,0.72,0.77155,179,0.555900621,
00.24.50,445,453,898,443,0.49,0.67269,298,0.331848552,
00.25.01,1554,1423,2977,1217,0.41,0.64667,787,0.264360094,
00.25.02,275,268,543,192,0.35,0.625,120,0.220994475,
00.25.03,122,136,258,133,0.52,0.71429,95,0.368217054,
00.25.04,123,124,247,156,0.63,0.58974,92,0.372469636,
00.25.05,52,60,112,67,0.6,0.80597,54,0.482142857,
00.25.06,323,330,653,365,0.56,0.63836,233,0.356814701,
00.25.07,141,139,280,159,0.57,0.85535,136,0.485714286,
00.25.08,54,43,97,52,0.54,0.5,26,0.268041237,
00.25.09,93,93,186,79,0.42,0.63291,50,0.268817204,
00.25.10,341,366,707,196,0.28,0.67857,133,0.188118812,
00.25.11,165,176,341,184,0.54,0.84783,156,0.457478006,
00.25.12,131,155,286,167,0.58,0.56287,94,0.328671329,
00.25.13,152,169,321,144,0.45,0.61111,88,0.274143302,
00.25.14,118,119,237,119,0.5,0.47899,57,0.240506329,
00.25.15,33,47,80,46,0.58,0.73913,34,0.425,
00.25.16,366,337,703,327,0.47,0.72171,236,0.335704125,
00.25.17,118,152,270,117,0.43,0.52991,62,0.22962963,
00.25.18,170,204,374,160,0.43,0.7625,122,0.326203209,
00.25.19,110,146,256,101,0.39,0.63366,64,0.25,
00.25.20,256,241,497,227,0.46,0.80176,182,0.366197183,
00.25.21,306,320,626,292,0.47,0.71233,208,0.332268371,
00.25.22,429,327,756,362,0.48,0.94199,341,0.451058201,
00.25.23,179,156,335,206,0.61,0.88835,183,0.546268657,
00.25.24,312,306,618,260,0.42,0.62308,162,0.262135922,
00.25.25,336,303,639,280,0.44,0.675,189,0.295774648,
00.25.26,261,178,439,207,0.47,0.6715,139,0.316628702,
00.25.27,245,270,515,249,0.48,0.63855,159,0.308737864,
00.25.28,150,173,323,68,0.21,0.63235,43,0.133126935,
00.25.29,266,181,447,220,0.49,0.83182,183,0.409395973,
00.25.30,561,423,984,435,0.44,0.92644,403,0.409552846,
00.25.31,153,121,274,143,0.52,0.71329,102,0.372262774,
00.25.32,557,515,1072,386,0.36,0.75907,293,0.273320896,
00.25.33,202,216,418,270,0.65,0.64074,173,0.413875598,
00.25.34,484,308,792,369,0.47,0.82927,306,0.386363636,
00.25.35,184,205,389,241,0.62,0.59336,143,0.367609254,
00.25.36,97,106,203,125,0.62,0.496,62,0.305418719,
00.25.37,242,160,402,164,0.41,0.73171,120,0.298507463,
00.25.38,138,120,258,145,0.56,0.85517,124,0.480620155,
00.25.39,167,121,288,161,0.56,0.84472,136,0.472222222,
00.26.01,1493,1144,2637,1321,0.5,0.676,893,0.338642397,
00.26.02,510,365,875,497,0.57,0.66197,329,0.376,
00.26.03,265,231,496,251,0.51,0.6255,157,0.316532258,
00.26.04,516,457,973,608,0.62,0.64309,391,0.401849949,
00.26.05,490,429,919,531,0.58,0.67797,360,0.391730141,
00.26.06,82,64,146,88,0.6,0.85227,75,0.51369863,
00.26.07,554,444,998,705,0.71,0.49645,350,0.350701403,
00.26.08,677,679,1356,802,0.59,0.55112,442,0.325958702,
00.26.09,223,211,434,297,0.68,0.64646,192,0.442396313,
00.26.10,83,102,185,124,0.67,0.54839,68,0.367567568,
00.26.11,272,308,580,363,0.63,0.75482,274,0.472413793,
00.26.12,214,216,430,290,0.67,0.64138,186,0.43255814,
00.26.13,91,109,200,147,0.74,0.68707,101,0.505,
00.26.14,400,419,819,532,0.65,0.6109,325,0.396825397,
00.26.15,129,131,260,156,0.6,0.6859,107,0.411538462,
00.26.16,98,106,204,141,0.69,0.64539,91,0.446078431,
00.26.17,365,406,771,450,0.58,0.56222,253,0.328145266,
00.26.18,80,87,167,116,0.69,0.56034,65,0.389221557,
00.26.19,167,201,368,237,0.64,0.62025,147,0.399456522,
00.26.20,194,213,407,224,0.55,0.66964,150,0.368550369,
00.26.21,180,188,368,221,0.6,0.70588,156,0.423913043,
00.26.22,650,583,1233,567,0.46,0.66314,376,0.304947283,
00.26.23,393,355,748,311,0.42,0.78778,245,0.327540107,
00.26.24,197,168,365,246,0.67,0.69919,172,0.471232877,
00.26.25,39,38,77,66,0.86,0.95455,63,0.818181818,
00.26.26,156,152,308,246,0.8,0.87398,215,0.698051948,
00.26.27,162,176,338,217,0.64,0.89862,195,0.576923077,
00.26.28,49,47,96,59,0.61,0.83051,49,0.510416667,
00.26.29,223,244,467,297,0.64,0.83838,249,0.533190578,
00.26.30,170,162,332,237,0.71,0.81013,192,0.578313253,
00.26.31,71,73,144,82,0.57,0.86585,71,0.493055556,
00.26.32,19,33,52,35,0.67,0.68571,24,0.461538462,
00.26.33,212,195,407,232,0.57,0.88362,205,0.503685504,
00.26.34,88,85,173,121,0.7,0.8595,104,0.601156069,
00.26.35,133,158,291,160,0.55,0.73125,117,0.402061856,
00.26.36,87,122,209,116,0.56,0.68966,80,0.38277512,
00.26.37,221,245,466,277,0.59,0.57762,160,0.343347639,
00.26.38,200,204,404,250,0.62,0.532,133,0.329207921,
00.26.39,115,134,249,148,0.59,0.71622,106,0.425702811,
00.26.40,35,30,65,55,0.85,0.83636,46,0.707692308,
00.27.01,805,614,1419,1053,0.74,0.52991,558,0.393234672,
00.27.02,1190,989,2179,1308,0.6,0.53135,695,0.318953648,
00.27.03,362,274,636,423,0.67,0.59102,250,0.393081761,
00.27.04,606,536,1142,829,0.73,0.538,446,0.390542907,
00.27.05,849,655,1504,1006,0.67,0.57256,576,0.382978723,
00.27.06,1172,1064,2236,1509,0.67,0.7104,1072,0.479427549,
00.27.07,727,678,1405,980,0.7,0.68469,671,0.477580071,
00.27.08,815,756,1571,885,0.56,0.55706,493,0.313812858,
00.27.09,419,398,817,546,0.67,0.6337,346,0.423500612,
00.27.10,503,556,1059,628,0.59,0.69268,435,0.410764873,
00.27.11,690,697,1387,843,0.61,0.78055,658,0.474405191,
00.27.12,488,511,999,605,0.61,0.7124,431,0.431431431,
00.27.13,182,179,361,261,0.72,0.61686,161,0.44598338,
00.27.14,740,719,1459,878,0.6,0.53189,467,0.320082248,
00.27.15,677,644,1321,808,0.61,0.49381,399,0.302043906,
00.27.16,664,607,1271,810,0.64,0.52963,429,0.337529504,
00.27.17,455,489,944,590,0.63,0.52542,310,0.328389831,
00.27.18,603,630,1233,831,0.67,0.54152,450,0.364963504,
00.27.19,250,242,492,345,0.7,0.5971,206,0.418699187,
00.27.20,448,450,898,519,0.58,0.54528,283,0.315144766,
00.27.21,432,445,877,571,0.65,0.60245,344,0.392246294,
00.27.22,251,234,485,289,0.6,0.52941,153,0.315463918,
00.27.23,497,514,1011,652,0.64,0.69172,451,0.446092977,
00.27.24,597,603,1200,736,0.61,0.63587,468,0.39,
00.27.25,435,437,872,517,0.59,0.53191,275,0.315366972,
00.27.26,707,600,1307,758,0.58,0.4657,353,0.270084162,
00.27.27,1213,1170,2383,1304,0.55,0.41258,538,0.225765841,
00.27.28,707,624,1331,873,0.66,0.43299,378,0.283996995,
00.27.29,700,647,1347,843,0.63,0.63938,539,0.400148478,
00.27.30,881,812,1693,1097,0.65,0.58706,644,0.380389841,
00.27.31,423,373,796,519,0.65,0.51252,266,0.334170854,
00.27.32,401,398,799,519,0.65,0.56069,291,0.364205257,
00.27.33,930,936,1866,1230,0.66,0.52764,649,0.347802787,
00.27.34,288,284,572,402,0.7,0.54975,221,0.386363636,
00.27.35,718,679,1397,919,0.66,0.63874,587,0.420186113,
00.27.36,283,270,553,390,0.71,0.65897,257,0.464737794,
00.27.37,222,251,473,355,0.75,0.5662,201,0.424947146,
00.27.38,416,419,835,538,0.64,0.63011,339,0.405988024,
00.27.39,428,437,865,535,0.62,0.46355,248,0.286705202,
00.27.40,0,0,0,363,0,0.89256,324,0,
00.27.41,0,0,0,89,0,0.91011,81,0,
00.28.01,749,607,1356,745,0.55,0.4953,369,0.272123894,
00.28.02,782,653,1435,705,0.49,0.55887,394,0.27456446,
00.28.03,750,649,1399,747,0.53,0.50469,377,0.269478199,
00.28.04,775,729,1504,715,0.48,0.53706,384,0.255319149,
00.28.05,478,446,924,479,0.52,0.56576,271,0.293290043,
00.28.06,1086,899,1985,1093,0.55,0.66514,727,0.366246851,
00.28.07,630,547,1177,635,0.54,0.63307,402,0.341546304,
00.28.08,112,108,220,96,0.44,0.66667,64,0.290909091,
00.28.09,249,233,482,332,0.69,0.5994,199,0.412863071,
00.28.10,348,355,703,378,0.54,0.67196,254,0.361308677,
00.28.11,286,322,608,378,0.62,0.74603,282,0.463815789,
00.28.12,200,224,424,240,0.57,0.7625,183,0.431603774,
00.28.13,643,589,1232,659,0.53,0.60395,398,0.323051948,
00.28.14,98,100,198,106,0.54,0.66038,70,0.353535354,
00.28.15,140,128,268,136,0.51,0.63971,87,0.324626866,
00.28.16,115,173,288,160,0.56,0.71875,115,0.399305556,
00.28.17,240,230,470,230,0.49,0.66087,152,0.323404255,
00.28.18,230,224,454,261,0.57,0.70115,183,0.4030837,
00.28.19,112,123,235,120,0.51,0.55833,67,0.285106383,
00.28.20,51,86,137,78,0.57,0.73077,57,0.416058394,
00.28.21,107,99,206,111,0.54,0.47748,53,0.257281553,
00.28.22,44,59,103,49,0.48,0.67347,33,0.32038835,
00.28.23,231,230,461,236,0.51,0.71186,168,0.364425163,
00.28.24,73,97,170,107,0.63,0.78505,84,0.494117647,
00.28.25,50,78,128,84,0.66,0.55952,47,0.3671875,
00.28.26,137,150,287,153,0.53,0.60131,92,0.320557491,
00.28.27,70,121,191,85,0.45,0.71765,61,0.319371728,
00.28.28,49,111,160,67,0.42,0.77612,52,0.325,
00.28.29,179,155,334,218,0.65,0.62385,136,0.407185629,
00.28.30,394,390,784,474,0.6,0.55907,265,0.338010204,
00.28.31,353,331,684,344,0.5,0.55523,191,0.279239766,
00.28.32,363,388,751,458,0.61,0.50218,230,0.306258322,
00.28.33,411,410,821,466,0.57,0.48927,228,0.27771011,
00.28.34,124,110,234,148,0.63,0.55405,82,0.35042735,
00.28.35,79,92,171,92,0.54,0.46739,43,0.251461988,
00.28.36,165,192,357,249,0.7,0.67068,167,0.467787115,
00.28.37,122,108,230,121,0.53,0.55372,67,0.291304348,
00.28.38,448,470,918,470,0.51,0.49149,231,0.251633987,
00.28.39,121,157,278,164,0.59,0.64024,105,0.377697842,
00.28.40,378,395,773,500,0.65,0.648,324,0.419146184,
00.28.41,136,140,276,179,0.65,0.61453,110,0.398550725,
00.28.42,161,160,321,191,0.6,0.68586,131,0.408099688,
00.28.43,296,324,620,419,0.68,0.52267,219,0.353225806,
00.28.44,101,114,215,158,0.73,0.5443,86,0.4,
00.28.45,242,284,526,326,0.62,0.51534,168,0.319391635,
00.28.46,295,298,593,338,0.57,0.51775,175,0.295109612,
00.28.47,73,87,160,83,0.52,0.60241,50,0.3125,
00.28.48,204,215,419,272,0.65,0.61397,167,0.398568019,
00.28.49,264,292,556,241,0.43,0.58506,141,0.253597122,
00.29.01,778,715,1493,934,0.63,0.7045,658,0.440723376,
00.29.02,269,216,485,321,0.66,0.72897,234,0.482474227,
00.29.03,322,311,633,376,0.59,0.72074,271,0.428120063,
00.29.04,140,168,308,184,0.6,0.75,138,0.448051948,
00.29.05,303,317,620,370,0.6,0.78108,289,0.466129032,
00.29.06,501,489,990,523,0.53,0.69216,362,0.365656566,
00.29.07,346,335,681,356,0.52,0.72472,258,0.378854626,
00.29.08,121,121,242,130,0.54,0.8,104,0.429752066,
00.29.09,46,82,128,96,0.75,0.78125,75,0.5859375,
00.29.10,83,148,231,180,0.78,0.71111,128,0.554112554,
00.30.01,647,563,1210,733,0.61,0.55389,406,0.33553719,
00.30.02,1211,968,2179,1121,0.51,0.52275,586,0.268930702,
00.30.03,739,658,1397,773,0.55,0.54851,424,0.303507516,
00.30.04,1427,1206,2633,1427,0.54,0.49474,706,0.268135207,
00.30.05,1078,1108,2186,960,0.44,0.54375,522,0.238792315,
00.30.06,607,616,1223,731,0.6,0.50068,366,0.299264105,
00.30.07,773,835,1608,681,0.42,0.72247,492,0.305970149,
00.30.08,1071,1074,2145,1308,0.61,0.55199,722,0.336596737,
00.30.09,410,398,808,516,0.64,0.58721,303,0.375,
00.30.10,489,503,992,653,0.66,0.67841,443,0.446572581,
00.30.11,630,615,1245,771,0.62,0.62127,479,0.384738956,
00.30.12,363,384,747,523,0.7,0.65392,342,0.457831325,
00.30.13,75,73,148,106,0.72,0.57547,61,0.412162162,
00.30.14,689,763,1452,952,0.66,0.58298,555,0.382231405,
00.30.15,609,601,1210,796,0.66,0.66457,529,0.437190083,
00.30.16,686,638,1324,781,0.59,0.49424,386,0.291540785,
00.30.17,162,179,341,222,0.65,0.68919,153,0.448680352,
00.30.18,341,344,685,402,0.59,0.76617,308,0.449635036,
00.30.19,612,650,1262,728,0.58,0.67995,495,0.392234548,
00.30.20,994,1019,2013,1233,0.61,0.65207,804,0.399403875,
00.30.21,272,237,509,268,0.53,0.57463,154,0.302554028,
00.30.22,597,626,1223,725,0.59,0.58483,424,0.346688471,
00.30.23,312,370,682,390,0.57,0.59487,232,0.340175953,
00.30.24,621,637,1258,612,0.49,0.80882,495,0.393481717,
00.30.25,291,294,585,371,0.63,0.67116,249,0.425641026,
00.30.26,343,355,698,464,0.66,0.67241,312,0.446991404,
00.30.27,729,753,1482,897,0.61,0.61427,551,0.371794872,
00.30.28,406,389,795,493,0.62,0.60446,298,0.374842767,
00.30.29,632,658,1290,803,0.62,0.66625,535,0.414728682,
00.30.30,703,638,1341,804,0.6,0.53234,428,0.319164802,
00.30.31,755,643,1398,853,0.61,0.56506,482,0.344778255,
00.30.32,444,460,904,545,0.6,0.50642,276,0.305309735,
00.32.01,739,618,1357,778,0.57,0.5527,430,0.316875461,
00.32.02,681,558,1239,700,0.56,0.50429,353,0.284907183,
00.32.03,692,478,1170,715,0.61,0.4979,356,0.304273504,
00.32.04,815,642,1457,859,0.59,0.50873,437,0.299931366,
00.32.05,798,620,1418,821,0.58,0.52741,433,0.305359661,
00.32.06,1351,1002,2353,1460,0.62,0.51644,754,0.320441989,
00.32.07,1125,875,2000,1276,0.64,0.53527,683,0.3415,
00.32.08,645,522,1167,678,0.58,0.50885,345,0.29562982,
00.32.09,775,699,1474,864,0.59,0.48727,421,0.285617368,
00.32.10,664,528,1192,788,0.66,0.54188,427,0.358221477,
00.32.11,636,467,1103,668,0.61,0.52844,353,0.320036265,
00.32.12,630,545,1175,784,0.67,0.56378,442,0.376170213,
00.32.13,552,526,1078,717,0.67,0.55788,400,0.371057514,
00.32.14,1035,801,1836,1082,0.59,0.48614,526,0.286492375,
00.32.15,1442,1149,2591,1370,0.53,0.4854,665,0.256657661,
00.32.16,1356,915,2271,1242,0.55,0.43317,538,0.236900044,
00.32.17,781,660,1441,837,0.58,0.50299,421,0.292158223,
00.32.18,553,442,995,651,0.65,0.49616,323,0.324623116,
00.32.19,794,616,1410,846,0.6,0.5,423,0.3,
00.32.20,820,610,1430,746,0.52,0.52949,395,0.276223776,
00.32.21,903,624,1527,825,0.54,0.49818,411,0.269155206,
00.32.22,1331,955,2286,1167,0.51,0.43445,507,0.221784777,
00.32.23,724,544,1268,674,0.53,0.44362,299,0.235804416,
00.32.24,747,580,1327,714,0.54,0.47339,338,0.254709872,
00.32.25,678,562,1240,787,0.63,0.50064,394,0.317741935,
00.32.26,393,371,764,559,0.73,0.59928,335,0.438481675,
00.32.27,265,276,541,279,0.52,0.52688,147,0.271719039,
00.32.28,744,732,1476,894,0.61,0.56823,508,0.344173442,
00.32.29,405,456,861,481,0.56,0.5447,262,0.304297329,
00.32.30,713,603,1316,762,0.58,0.62336,475,0.360942249,
00.32.31,270,305,575,320,0.56,0.55938,179,0.311304348,
00.32.32,380,369,749,450,0.6,0.58,261,0.348464619,
00.32.33,362,407,769,446,0.58,0.52242,233,0.302990897,
00.32.34,1193,1159,2352,1327,0.56,0.60512,803,0.341411565,
00.32.35,342,381,723,399,0.55,0.55388,221,0.305670816,
00.32.36,306,304,610,352,0.58,0.54261,191,0.313114754,
00.32.37,143,170,313,154,0.49,0.7013,108,0.345047923,
00.32.38,624,604,1228,807,0.66,0.64436,520,0.423452769,
00.32.39,583,539,1122,683,0.61,0.63397,433,0.385918004,
00.32.40,808,729,1537,986,0.64,0.71602,706,0.45933637,
00.32.41,677,693,1370,816,0.6,0.66667,544,0.397080292,
00.32.42,225,258,483,324,0.67,0.6358,206,0.426501035,
00.32.43,376,425,801,460,0.57,0.62826,289,0.360799001,
00.32.44,691,744,1435,831,0.58,0.63177,525,0.365853659,
00.32.45,414,447,861,487,0.57,0.53593,261,0.303135889,
00.32.46,656,598,1254,718,0.57,0.64067,460,0.366826156,
00.32.47,493,462,955,593,0.62,0.49578,294,0.307853403,
00.32.48,687,665,1352,725,0.54,0.5669,411,0.303994083,
00.32.49,768,709,1477,740,0.5,0.53514,396,0.268111036,
00.32.50,637,650,1287,812,0.63,0.67241,546,0.424242424,
00.32.51,649,568,1217,671,0.55,0.64829,435,0.357436319,
00.32.52,481,403,884,533,0.6,0.60038,320,0.36199095,
00.32.53,445,368,813,504,0.62,0.57738,291,0.357933579,
00.32.54,782,669,1451,827,0.57,0.526,435,0.299793246,
00.32.55,1444,1278,2722,1598,0.59,0.50563,808,0.296840558,
00.32.56,909,1011,1920,931,0.48,0.5188,483,0.2515625,
00.32.57,161,154,315,169,0.54,0.57396,97,0.307936508,
00.32.58,475,401,876,596,0.68,0.56879,339,0.386986301,
00.32.59,509,504,1013,637,0.63,0.72057,459,0.453109576,
00.32.60,339,317,656,398,0.61,0.68342,272,0.414634146,
00.32.61,790,769,1559,934,0.6,0.53961,504,0.323284157,
00.32.62,729,682,1411,780,0.55,0.57564,449,0.318214033,
00.32.63,671,642,1313,817,0.62,0.62301,509,0.387661843,
00.32.64,520,533,1053,609,0.58,0.66667,406,0.385565052,
00.32.65,214,230,444,256,0.58,0.69141,177,0.398648649,
00.32.66,616,548,1164,740,0.64,0.72027,533,0.45790378,
00.32.67,770,710,1480,854,0.58,0.637,544,0.367567568,
00.32.68,406,404,810,504,0.62,0.52579,265,0.327160494,
00.32.69,569,588,1157,650,0.56,0.57692,375,0.324114088,
00.32.70,450,377,827,498,0.6,0.55823,278,0.336154776,
00.32.71,1057,1132,2189,1396,0.64,0.64327,898,0.410232983,
00.32.72,258,310,568,404,0.71,0.64356,260,0.457746479,
00.32.73,525,468,993,625,0.63,0.4944,309,0.311178248,
00.32.74,423,452,875,562,0.64,0.61388,345,0.394285714,
00.32.75,638,603,1241,737,0.59,0.72592,535,0.431103948,
00.32.76,223,246,469,305,0.65,0.68525,209,0.445628998,
00.32.77,693,697,1390,877,0.63,0.78563,689,0.495683453,
00.32.78,732,731,1463,879,0.6,0.59499,523,0.357484621,
00.32.79,748,736,1484,921,0.62,0.5798,534,0.359838275,
00.32.80,869,940,1809,1070,0.59,0.5729,613,0.338861249,
00.32.81,186,183,369,232,0.63,0.60345,140,0.379403794,
00.32.82,543,566,1109,633,0.57,0.54818,347,0.3128945,
00.32.83,760,730,1490,756,0.51,0.58995,446,0.299328859,
00.32.84,651,643,1294,881,0.68,0.6118,539,0.416537867,
00.32.85,162,161,323,253,0.78,0.52569,133,0.411764706,
00.32.86,88,87,175,112,0.64,0.61607,69,0.394285714,
00.32.87,102,107,209,156,0.75,0.62179,97,0.464114833,
00.32.88,218,208,426,305,0.72,0.57049,174,0.408450704,
00.32.89,139,146,285,216,0.76,0.46759,101,0.354385965,
00.32.90,487,441,928,467,0.5,0.59957,280,0.301724138,
00.32.91,448,507,955,509,0.53,0.55599,283,0.296335079,
00.32.92,521,518,1039,600,0.58,0.56667,340,0.327237729,
00.32.93,716,685,1401,766,0.55,0.70757,542,0.386866524,
00.32.94,365,325,690,382,0.55,0.57592,220,0.31884058,
00.32.95,723,658,1381,940,0.68,0.53404,502,0.363504707,
00.33.01,756,669,1425,933,0.65,0.59914,559,0.392280702,
00.33.02,694,641,1335,830,0.62,0.56988,473,0.354307116,
00.33.03,759,708,1467,861,0.59,0.54355,468,0.319018405,
00.33.04,926,785,1711,948,0.55,0.54641,518,0.302746932,
00.33.05,589,505,1094,619,0.57,0.53312,330,0.301645338,
00.33.06,961,953,1914,1112,0.58,0.57734,642,0.335423197,
00.33.07,451,522,973,605,0.62,0.66116,400,0.411099692,
00.33.08,615,644,1259,770,0.61,0.53766,414,0.328832407,
00.33.09,205,252,457,305,0.67,0.51803,158,0.345733042,
00.33.10,504,518,1022,726,0.71,0.68457,497,0.48630137,
00.33.11,105,101,206,122,0.59,0.77049,94,0.45631068,
00.33.12,556,612,1168,781,0.67,0.73624,575,0.492294521,
00.33.13,429,421,850,588,0.69,0.62245,366,0.430588235,
00.33.14,614,660,1274,780,0.61,0.62692,489,0.383830455,
00.33.15,355,409,764,502,0.66,0.69124,347,0.454188482,
00.33.16,398,393,791,511,0.65,0.60274,308,0.389380531,
00.33.17,229,225,454,278,0.61,0.43525,121,0.266519824,
00.33.18,761,667,1428,924,0.65,0.56494,522,0.365546218,
00.33.19,1168,1210,2378,1373,0.58,0.64822,890,0.374264087,
00.33.20,610,612,1222,760,0.62,0.58026,441,0.360883797,
00.33.21,421,432,853,527,0.62,0.537,283,0.331770223,
00.33.22,206,224,430,278,0.65,0.65827,183,0.425581395,
00.33.23,256,222,478,270,0.56,0.68889,186,0.389121339,
00.33.24,127,112,239,132,0.55,0.64394,85,0.355648536,
00.33.25,915,873,1788,1099,0.61,0.57234,629,0.351789709,
00.33.26,510,588,1098,681,0.62,0.6094,415,0.377959927,
00.33.27,715,782,1497,845,0.56,0.6568,555,0.370741483,
00.33.28,701,767,1468,831,0.57,0.6065,504,0.343324251,
00.33.29,720,732,1452,914,0.63,0.63457,580,0.399449036,
00.33.30,454,472,926,662,0.71,0.65408,433,0.467602592,
00.33.31,799,816,1615,987,0.61,0.58156,574,0.355417957,
00.33.32,162,154,316,197,0.62,0.73096,144,0.455696203,
00.33.33,106,113,219,150,0.68,0.76667,115,0.525114155,
00.33.34,808,701,1509,879,0.58,0.6678,587,0.388999337,
00.33.35,67,65,132,107,0.81,0.52336,56,0.424242424,
00.35.01,1166,1156,2322,1313,0.57,0.47753,627,0.27002584,
00.35.02,1305,1150,2455,1491,0.61,0.55265,824,0.335641548,
00.35.03,740,623,1363,763,0.56,0.5308,405,0.297138665,
00.35.04,1017,974,1991,1091,0.55,0.49129,536,0.269211452,
00.35.05,1236,1111,2347,1419,0.6,0.5074,720,0.306774606,
00.35.06,1056,936,1992,1168,0.59,0.46661,545,0.273594378,
00.35.07,1094,915,2009,1216,0.61,0.51563,627,0.31209557,
00.35.08,1109,1044,2153,1312,0.61,0.51829,680,0.315838365,
00.35.09,1092,904,1996,1063,0.53,0.48354,514,0.25751503,
00.35.10,708,656,1364,766,0.56,0.50261,385,0.282258065,
00.35.11,493,423,916,430,0.47,0.52093,224,0.244541485,
00.35.12,312,353,665,406,0.61,0.47044,191,0.287218045,
00.35.13,1157,1160,2317,1241,0.54,0.4448,552,0.238239102,
00.35.14,1188,1111,2299,1328,0.58,0.47816,635,0.276207047,
00.35.15,1140,1021,2161,1200,0.56,0.45,540,0.249884313,
00.35.16,211,255,466,312,0.67,0.51923,162,0.347639485,
00.35.17,433,504,937,622,0.66,0.59968,373,0.398078975,
00.35.18,120,139,259,187,0.72,0.5615,105,0.405405405,
00.35.19,338,358,696,423,0.61,0.61702,261,0.375,
00.35.20,594,539,1133,733,0.65,0.58799,431,0.380406002,
00.35.21,198,208,406,278,0.68,0.54676,152,0.374384236,
00.35.22,530,547,1077,664,0.62,0.60241,400,0.371402043,
00.35.23,859,866,1725,1045,0.61,0.57608,602,0.348985507,
00.35.24,412,411,823,529,0.64,0.65028,344,0.417982989,
00.35.25,234,268,502,318,0.63,0.56289,179,0.356573705,
00.35.26,638,675,1313,842,0.64,0.52138,439,0.334348819,
00.35.27,578,512,1090,665,0.61,0.51429,342,0.313761468,
00.35.28,484,486,970,616,0.64,0.59091,364,0.375257732,
00.35.29,391,413,804,526,0.65,0.61977,326,0.405472637,
00.35.30,825,824,1649,1010,0.61,0.54752,553,0.33535476,
00.35.31,395,383,778,418,0.54,0.62679,262,0.336760925,
00.35.32,217,216,433,283,0.65,0.55477,157,0.362586605,
00.35.33,207,214,421,292,0.69,0.59247,173,0.410926366,
00.35.34,32,32,64,53,0.83,0.60377,32,0.5,
00.35.35,58,75,133,104,0.78,0.57692,60,0.45112782,
00.35.36,1178,1090,2268,1251,0.55,0.47002,588,0.259259259,
00.35.37,464,488,952,517,0.54,0.47776,247,0.259453782,
00.35.38,306,319,625,386,0.62,0.62953,243,0.3888,
00.36.01,989,763,1752,1016,0.58,0.57776,587,0.335045662,
00.36.02,567,472,1039,565,0.54,0.55929,316,0.304138595,
00.36.03,1119,843,1962,1227,0.63,0.59169,726,0.370030581,
00.36.04,894,754,1648,942,0.57,0.59979,565,0.342839806,
00.36.05,944,754,1698,1054,0.62,0.59203,624,0.367491166,
00.36.06,946,819,1765,994,0.56,0.52515,522,0.295750708,
00.36.07,598,427,1025,593,0.58,0.56661,336,0.327804878,
00.36.08,420,399,819,434,0.53,0.5,217,0.264957265,
00.36.09,884,819,1703,1002,0.59,0.68563,687,0.403405755,
00.36.10,531,466,997,622,0.62,0.67363,419,0.420260782,
00.36.11,630,514,1144,696,0.61,0.63793,444,0.388111888,
00.36.12,161,176,337,215,0.64,0.68372,147,0.43620178,
00.36.13,872,761,1633,1067,0.65,0.64386,687,0.420698102,
00.36.14,168,177,345,205,0.59,0.7122,146,0.423188406,
00.36.15,699,617,1316,841,0.64,0.73127,615,0.467325228,
00.36.16,330,330,660,385,0.58,0.60779,234,0.354545455,
00.36.17,256,270,526,217,0.41,0.8894,193,0.366920152,
00.36.18,820,836,1656,1090,0.66,0.57523,627,0.378623188,
00.36.19,583,520,1103,722,0.65,0.62465,451,0.408884859,
00.36.20,721,668,1389,909,0.65,0.56216,511,0.367890569,
00.36.21,337,305,642,432,0.67,0.52778,228,0.355140187,
00.36.22,343,315,658,442,0.67,0.60633,268,0.407294833,
00.36.23,348,296,644,260,0.4,0.80769,210,0.326086957,
00.36.24,91,91,182,74,0.41,0.75676,56,0.307692308,
00.37.01,1220,949,2169,1357,0.63,0.54458,739,0.340710005,
00.37.02,1334,1126,2460,1479,0.6,0.68019,1006,0.408943089,
00.37.03,638,521,1159,798,0.69,0.57393,458,0.395168248,
00.37.04,1252,1075,2327,1387,0.6,0.58688,814,0.349806618,
00.37.05,625,524,1149,662,0.58,0.56798,376,0.327241079,
00.37.06,552,481,1033,661,0.64,0.53707,355,0.343659245,
00.37.07,355,318,673,403,0.6,0.65757,265,0.393759287,
00.37.08,1169,1023,2192,1465,0.67,0.52355,767,0.349908759,
00.37.09,601,619,1220,810,0.66,0.42716,346,0.283606557,
00.37.10,1092,909,2001,1194,0.6,0.48325,577,0.288355822,
00.37.11,178,145,323,211,0.65,0.8436,178,0.551083591,
00.37.12,644,713,1357,933,0.69,0.59486,555,0.40899042,
00.37.13,240,235,475,335,0.71,0.6209,208,0.437894737,
00.37.14,521,528,1049,719,0.69,0.63421,456,0.434699714,
00.37.15,330,353,683,471,0.69,0.62208,293,0.428989751,
00.37.16,667,675,1342,906,0.68,0.55629,504,0.375558867,
00.37.17,490,492,982,688,0.7,0.61773,425,0.432790224,
00.37.18,554,434,988,574,0.58,0.87282,501,0.50708502,
00.37.19,244,190,434,298,0.69,0.97651,291,0.670506912,
00.37.20,346,362,708,465,0.66,0.53548,249,0.351694915,
00.37.21,773,712,1485,818,0.55,0.73716,603,0.406060606,
00.37.22,789,822,1611,1116,0.69,0.56093,626,0.388578523,
00.37.23,390,414,804,553,0.69,0.56962,315,0.391791045,
00.37.24,679,500,1179,633,0.54,0.88626,561,0.475826972,
00.37.25,705,612,1317,795,0.6,0.51447,409,0.31055429,
00.37.26,218,156,374,208,0.56,0.96635,201,0.537433155,
00.37.27,611,567,1178,835,0.71,0.93772,783,0.664685908,
00.37.28,401,462,863,521,0.6,0.50864,265,0.307068366,
00.38.01,874,772,1646,1135,0.69,0.70661,802,0.487241798,
00.38.02,666,512,1178,766,0.65,0.72846,558,0.473684211,
00.38.03,689,729,1418,1068,0.75,0.53464,571,0.402679831,
00.38.04,416,450,866,634,0.73,0.69243,439,0.506928406,
00.38.05,478,532,1010,690,0.68,0.80145,553,0.547524752,
00.38.06,786,813,1599,1041,0.65,0.73103,761,0.475922452,
00.38.07,392,435,827,530,0.64,0.63962,339,0.409915357,
00.38.08,408,465,873,525,0.6,0.64,336,0.384879725,
00.38.09,339,355,694,446,0.64,0.6435,287,0.413544669,
00.38.10,221,229,450,273,0.61,0.60073,164,0.364444444,
00.38.11,132,122,254,212,0.83,0.82547,175,0.688976378,
00.38.12,693,662,1355,998,0.74,0.58216,581,0.428782288,
00.38.13,178,209,387,274,0.71,0.70438,193,0.49870801,
00.38.14,364,432,796,540,0.68,0.63889,345,0.433417085,
00.38.15,370,380,750,505,0.67,0.68911,348,0.464,
00.38.16,642,673,1315,951,0.72,0.57098,543,0.412927757,
00.39.01,785,684,1469,1014,0.69,0.68146,691,0.470388019,
00.39.02,133,137,270,204,0.76,0.76961,157,0.581481481,
00.39.03,202,222,424,312,0.74,0.67949,212,0.5,
00.39.04,630,483,1113,636,0.57,0.95283,606,0.544474394,
00.39.05,30,40,70,63,0.9,0.74603,47,0.671428571,
00.39.06,43,49,92,66,0.72,0.72727,48,0.52173913,
00.39.07,144,157,301,217,0.72,0.70046,152,0.504983389,
00.39.08,226,253,479,351,0.73,0.67806,238,0.496868476,
00.39.09,215,240,455,352,0.77,0.56534,199,0.437362637,
00.39.10,139,163,302,254,0.84,0.59055,150,0.496688742,
00.39.11,106,105,211,141,0.67,0.75177,106,0.502369668,
00.39.12,144,148,292,216,0.74,0.79167,171,0.585616438,
00.39.13,60,59,119,102,0.86,0.62745,64,0.537815126,
00.39.14,58,69,127,97,0.76,0.65979,64,0.503937008,
00.39.15,176,179,355,285,0.8,0.64211,183,0.515492958,
00.39.16,213,233,446,346,0.78,0.65029,225,0.504484305,
00.39.17,122,110,232,145,0.63,0.66207,96,0.413793103,
00.39.18,191,198,389,304,0.78,0.77632,236,0.606683805,
00.39.19,131,158,289,221,0.76,0.76018,168,0.581314879,
00.39.20,267,295,562,383,0.68,0.55614,213,0.379003559,
00.39.21,71,100,171,138,0.81,0.55797,77,0.450292398,
00.39.22,110,142,252,195,0.77,0.61538,120,0.476190476,
00.39.23,723,628,1351,1039,0.77,0.69779,725,0.536639526,
00.40.01,1654,1356,3010,1327,0.44,0.86511,1148,0.381395349,
00.40.02,1191,932,2123,918,0.43,0.83769,769,0.362223269,
00.40.03,507,469,976,600,0.61,0.935,561,0.574795082,
00.40.04,224,170,394,190,0.48,0.79474,151,0.383248731,
00.40.05,208,167,375,199,0.53,0.95477,190,0.506666667,
00.40.06,139,129,268,123,0.46,0.84553,104,0.388059701,
00.40.07,283,251,534,312,0.58,0.90385,282,0.528089888,
00.40.08,245,218,463,286,0.62,0.81818,234,0.505399568,
00.40.09,164,164,328,197,0.6,0.84772,167,0.509146341,
00.40.10,396,298,694,330,0.48,0.86667,286,0.412103746,
00.40.11,346,229,575,280,0.49,0.925,259,0.450434783,
00.40.12,227,183,410,261,0.64,0.95785,250,0.609756098,
00.40.13,319,189,508,212,0.42,0.91038,193,0.37992126,
00.40.14,367,306,673,425,0.63,0.86824,369,0.548291233,
00.40.15,431,382,813,583,0.72,0.93825,547,0.672816728,
00.40.16,348,327,675,221,0.33,0.9276,205,0.303703704,
00.40.17,136,132,268,221,0.82,0.8914,197,0.735074627,
00.40.18,127,121,248,190,0.77,0.94737,180,0.725806452,
00.40.19,136,144,280,176,0.63,0.65341,115,0.410714286,
00.40.20,42,54,96,80,0.83,0.7875,63,0.65625,
00.40.21,1007,816,1823,911,0.5,0.94731,863,0.473395502,
00.40.22,714,564,1278,478,0.37,0.87657,419,0.327856025,
00.40.23,235,205,440,242,0.55,0.83471,202,0.459090909,
00.40.24,167,153,320,196,0.61,0.85714,168,0.525,
00.40.25,187,143,330,198,0.6,0.93939,186,0.563636364,
00.40.26,205,198,403,269,0.67,0.89963,242,0.600496278,
00.40.27,221,162,383,267,0.7,0.97004,259,0.676240209,
00.40.28,409,316,725,409,0.56,0.9291,380,0.524137931,
00.40.29,284,245,529,336,0.64,0.92262,310,0.586011342,
00.40.30,54,42,96,61,0.64,0.83607,51,0.53125,
00.40.31,683,493,1176,826,0.7,0.94552,781,0.664115646,
00.40.32,538,390,928,546,0.59,0.94872,518,0.558189655,
00.40.33,260,224,484,351,0.73,0.92308,324,0.669421488,
00.40.34,395,332,727,439,0.6,0.90888,399,0.548830812,
00.40.35,72,53,125,97,0.78,0.96907,94,0.752,
00.40.36,335,289,624,376,0.6,0.67819,255,0.408653846,
00.40.37,26,21,47,33,0.7,0.69697,23,0.489361702,
00.40.38,190,203,393,293,0.75,0.66894,196,0.498727735,
00.40.39,183,168,351,186,0.53,0.77419,144,0.41025641,
00.40.40,233,209,442,169,0.38,0.90533,153,0.346153846,
00.40.41,175,159,334,164,0.49,0.95122,156,0.467065868,
00.40.42,373,386,759,468,0.62,0.84402,395,0.520421607,
00.40.43,80,75,155,77,0.5,0.85714,66,0.425806452,
00.40.44,51,37,88,61,0.69,0.88525,54,0.613636364,
00.40.45,886,686,1572,902,0.57,0.94013,848,0.539440204,
00.40.46,155,145,300,247,0.82,0.8664,214,0.713333333,
00.40.47,192,218,410,249,0.61,0.58635,146,0.356097561,
00.40.48,75,74,149,135,0.91,0.91111,123,0.825503356,
00.40.49,51,59,110,82,0.75,0.78049,64,0.581818182,
00.40.50,137,133,270,254,0.94,0.88189,224,0.82962963,
00.40.51,315,262,577,358,0.62,0.91061,326,0.564991334,
00.40.52,321,296,617,403,0.65,0.92556,373,0.604538088,
00.40.53,66,52,118,92,0.78,0.75,69,0.584745763,
00.40.54,47,43,90,48,0.53,0.85417,41,0.455555556,
00.40.55,394,287,681,340,0.5,0.82353,280,0.411160059,
00.40.56,132,141,273,181,0.66,0.69061,125,0.457875458,
00.40.57,197,185,382,220,0.58,0.87727,193,0.505235602,
00.40.58,551,364,915,369,0.4,0.84824,313,0.342076503,
00.40.59,294,262,556,384,0.69,0.77083,296,0.532374101,
00.40.60,392,280,672,461,0.69,0.95879,442,0.657738095,
00.40.61,208,179,387,278,0.72,0.95324,265,0.684754522,
00.40.62,1566,1180,2746,1129,0.41,0.82994,937,0.341223598,
00.41.01,799,685,1484,750,0.51,0.89067,668,0.450134771,
00.41.02,892,755,1647,822,0.5,0.86983,715,0.434122647,
00.41.03,689,635,1324,844,0.64,0.90758,766,0.578549849,
00.41.04,690,665,1355,758,0.56,0.8496,644,0.475276753,
00.41.05,651,622,1273,758,0.6,0.8628,654,0.513747054,
00.41.06,33,41,74,56,0.76,0.76786,43,0.581081081,
00.41.07,449,387,836,465,0.56,0.93763,436,0.5215311,
00.41.08,470,453,923,533,0.58,0.86492,461,0.499458288,
00.41.09,210,210,420,246,0.59,0.84959,209,0.497619048,
00.41.10,201,172,373,225,0.6,0.90667,204,0.54691689,
00.41.11,246,213,459,279,0.61,0.95699,267,0.581699346,
00.41.12,314,377,691,369,0.53,0.82114,303,0.438494935,
00.41.13,64,75,139,103,0.74,0.8932,92,0.661870504,
00.41.14,174,140,314,216,0.69,0.93519,202,0.643312102,
00.41.15,30,26,56,87,1.55,0.77011,67,1.196428571,
00.41.16,101,113,214,152,0.71,0.55921,85,0.397196262,
00.41.17,51,58,109,71,0.65,0.91549,65,0.596330275,
00.41.18,565,490,1055,608,0.58,0.87171,530,0.502369668,
00.41.19,236,210,446,282,0.63,0.78369,221,0.495515695,
00.41.20,115,108,223,192,0.86,0.91146,175,0.784753363,
00.41.21,807,580,1387,844,0.61,0.95735,808,0.582552271,
00.41.22,189,160,349,252,0.72,0.93254,235,0.673352436,
00.41.23,118,100,218,145,0.67,0.90345,131,0.600917431,
00.41.24,107,103,210,156,0.74,0.96154,150,0.714285714,
00.41.25,711,599,1310,755,0.58,0.90066,680,0.519083969,
00.41.26,352,277,629,372,0.59,0.88978,331,0.526232114,
00.41.27,275,257,532,264,0.5,0.93939,248,0.466165414,
00.41.28,168,159,327,198,0.61,0.92929,184,0.562691131,
00.41.29,65,68,133,73,0.55,0.91781,67,0.503759398,
00.41.30,14,27,41,27,0.66,0.92593,25,0.609756098,
00.41.31,110,119,229,161,0.7,0.67702,109,0.475982533,
00.41.32,553,599,1152,475,0.41,0.82105,390,0.338541667,
00.41.33,28,33,61,50,0.82,0.88,44,0.721311475,
00.41.34,375,285,660,382,0.58,0.91623,350,0.53030303,
00.41.35,36,35,71,46,0.65,0.82609,38,0.535211268,
00.43.01,761,634,1395,848,0.61,0.54835,465,0.333333333,
00.43.02,583,480,1063,640,0.6,0.58906,377,0.354656632,
00.43.03,41,52,93,59,0.63,0.72881,43,0.462365591,
00.43.04,185,198,383,233,0.61,0.69957,163,0.425587467,
00.43.05,97,112,209,142,0.68,0.57746,82,0.392344498,
00.43.06,48,63,111,94,0.85,0.64894,61,0.54954955,
00.43.07,12,23,35,37,1.06,0.83784,31,0.885714286,
00.43.08,75,105,180,132,0.73,0.59091,78,0.433333333,
00.43.09,118,136,254,171,0.67,0.63158,108,0.42519685,
00.43.10,107,91,198,148,0.75,0.63514,94,0.474747475,
00.43.11,172,160,332,230,0.69,0.76522,176,0.530120482,
00.43.12,61,51,112,83,0.74,0.66265,55,0.491071429,
00.43.13,53,46,99,76,0.77,0.64474,49,0.494949495,
00.43.14,45,44,89,75,0.84,0.8,60,0.674157303,
00.43.15,292,240,532,353,0.66,0.6119,216,0.406015038,
00.43.16,249,229,478,323,0.68,0.62539,202,0.422594142,
00.43.17,172,165,337,227,0.67,0.57709,131,0.388724036,
00.43.18,49,69,118,89,0.75,0.70787,63,0.533898305,
00.43.19,60,64,124,93,0.75,0.58065,54,0.435483871,
00.43.20,43,64,107,67,0.63,0.59701,40,0.373831776,
00.43.21,157,154,311,175,0.56,0.56,98,0.31511254,
00.43.22,138,144,282,150,0.53,0.54,81,0.287234043,
00.43.23,65,60,125,83,0.66,0.68675,57,0.456,
00.44.01,171,141,312,208,0.67,0.61058,127,0.407051282,
00.44.02,214,226,440,300,0.68,0.67333,202,0.459090909,
00.44.03,263,247,510,353,0.69,0.64589,228,0.447058824,
00.44.04,255,236,491,374,0.76,0.70856,265,0.539714868,
00.44.05,572,488,1060,715,0.67,0.5972,427,0.402830189,
00.44.06,695,541,1236,829,0.67,0.55006,456,0.368932039,
00.44.07,87,97,184,145,0.79,0.61379,89,0.483695652,
00.44.08,63,81,144,97,0.67,0.54639,53,0.368055556,
00.44.09,73,73,146,114,0.78,0.74561,85,0.582191781,
00.44.10,27,15,42,32,0.76,0.9375,30,0.714285714,
00.44.11,115,127,242,178,0.74,0.62921,112,0.462809917,
00.44.12,135,147,282,186,0.66,0.61828,115,0.407801418,
00.44.13,165,165,330,233,0.71,0.70815,165,0.5,
00.44.14,48,43,91,69,0.76,0.66667,46,0.505494505,
00.44.15,288,261,549,345,0.63,0.66667,230,0.418943534,
00.44.16,48,47,95,74,0.78,0.66216,49,0.515789474,
00.44.17,48,65,113,69,0.61,0.53623,37,0.327433628,
00.44.18,22,27,49,38,0.78,0.68421,26,0.530612245,
00.44.19,356,356,712,487,0.68,0.62423,304,0.426966292,
00.44.20,127,122,249,220,0.88,0.72727,160,0.642570281,
00.44.21,232,213,445,302,0.68,0.70199,212,0.476404494,
00.44.22,72,100,172,117,0.68,0.76068,89,0.51744186,
00.44.23,100,82,182,133,0.73,0.66917,89,0.489010989,
00.44.24,169,158,327,240,0.73,0.6375,153,0.467889908,
00.44.25,79,86,165,127,0.77,0.70866,90,0.545454545,
00.44.26,93,107,200,160,0.8,0.61875,99,0.495,
00.44.27,266,274,540,342,0.63,0.64912,222,0.411111111,
00.44.28,271,286,557,387,0.69,0.56589,219,0.393177738,
00.44.29,127,134,261,199,0.76,0.54774,109,0.417624521,
00.44.30,172,183,355,248,0.7,0.72177,179,0.504225352,
00.44.31,132,144,276,196,0.71,0.63265,124,0.449275362,
00.44.32,239,206,445,268,0.6,0.67537,181,0.406741573,
00.44.33,94,108,202,134,0.66,0.64179,86,0.425742574,
00.44.34,75,65,140,95,0.68,0.64211,61,0.435714286,
00.44.35,46,42,88,70,0.8,0.68571,48,0.545454545,
00.44.36,37,37,74,52,0.7,0.5,26,0.351351351,
00.45.01,383,295,678,443,0.65,0.62302,276,0.407079646,
00.45.02,135,139,274,172,0.63,0.59302,102,0.372262774,
00.45.03,101,99,200,127,0.64,0.62205,79,0.395,
00.45.04,104,104,208,152,0.73,0.73684,112,0.538461538,
00.45.05,148,146,294,180,0.61,0.63333,114,0.387755102,
00.45.06,209,213,422,284,0.67,0.71831,204,0.483412322,
00.45.07,43,56,99,67,0.68,0.50746,34,0.343434343,
00.45.08,147,150,297,172,0.58,0.75581,130,0.437710438,
00.45.09,25,33,58,44,0.76,0.63636,28,0.482758621,
00.45.10,66,60,126,83,0.66,0.62651,52,0.412698413,
00.45.11,128,152,280,206,0.74,0.69417,143,0.510714286,
00.45.12,95,97,192,144,0.75,0.56944,82,0.427083333,
00.45.13,104,115,219,140,0.64,0.62143,87,0.397260274,
00.45.14,91,92,183,116,0.63,0.60345,70,0.382513661,
00.45.15,42,50,92,74,0.8,0.71622,53,0.576086957,
00.45.16,139,142,281,162,0.58,0.56173,91,0.323843416,
00.45.17,184,209,393,215,0.55,0.56744,122,0.31043257,
00.45.18,384,346,730,391,0.54,0.64962,254,0.347945205,
00.45.19,33,38,71,60,0.85,0.56667,34,0.478873239,
00.45.20,208,194,402,284,0.71,0.46127,131,0.325870647,
00.45.21,18,18,36,34,0.94,0.64706,22,0.611111111,
00.45.22,75,68,143,99,0.69,0.67677,67,0.468531469,
00.45.23,121,125,246,160,0.65,0.75,120,0.487804878,
00.45.24,115,117,232,150,0.65,0.6,90,0.387931034,
00.45.25,467,446,913,596,0.65,0.64765,386,0.422782037,
00.45.26,66,73,139,69,0.5,0.5942,41,0.294964029,
00.45.27,59,71,130,86,0.66,0.63953,55,0.423076923,
00.45.28,98,111,209,139,0.67,0.43885,61,0.291866029,
00.45.29,264,275,539,395,0.73,0.60759,240,0.445269017,
00.45.30,103,133,236,177,0.75,0.61582,109,0.461864407,
00.45.31,299,310,609,395,0.65,0.66076,261,0.428571429,
00.45.32,34,57,91,52,0.57,0.67308,35,0.384615385,
00.45.33,41,50,91,63,0.69,0.73016,46,0.505494505,
00.45.34,127,153,280,207,0.74,0.60386,125,0.446428571,
00.45.35,64,68,132,102,0.77,0.57843,59,0.446969697,
00.45.36,11,14,25,23,0.92,0.78261,18,0.72,
00.45.37,367,289,656,408,0.62,0.66176,270,0.411585366,
00.45.38,33,51,84,64,0.76,0.70313,45,0.535714286,
00.45.39,27,28,55,42,0.76,0.47619,20,0.363636364,
00.45.40,18,21,39,36,0.92,0.55556,20,0.512820513,
00.45.41,28,18,46,39,0.85,0.69231,27,0.586956522,
00.46.01,723,610,1333,717,0.54,0.7378,529,0.396849212,
00.46.02,81,104,185,107,0.58,0.70093,75,0.405405405,
00.46.03,145,157,302,170,0.56,0.75882,129,0.427152318,
00.46.04,61,79,140,96,0.69,0.66667,64,0.457142857,
00.46.05,114,122,236,152,0.64,0.75,114,0.483050847,
00.46.06,66,92,158,78,0.49,0.58974,46,0.291139241,
00.46.07,178,200,378,245,0.65,0.74286,182,0.481481481,
00.46.08,51,79,130,100,0.77,0.88,88,0.676923077,
00.46.09,138,181,319,173,0.54,0.76879,133,0.4169279,
00.46.10,48,60,108,71,0.66,0.73239,52,0.481481481,
00.46.11,98,122,220,115,0.52,0.82609,95,0.431818182,
00.46.12,193,207,400,201,0.5,0.76617,154,0.385,
00.46.13,141,147,288,190,0.66,0.82105,156,0.541666667,
00.46.14,122,140,262,130,0.5,0.63846,83,0.316793893,
00.46.15,71,77,148,101,0.68,0.85149,86,0.581081081,
00.46.16,19,27,46,40,0.87,0.8,32,0.695652174,
00.46.17,130,125,255,142,0.56,0.72535,103,0.403921569,
00.46.18,71,92,163,107,0.66,0.78505,84,0.515337423,
00.46.19,51,66,117,73,0.62,0.69863,51,0.435897436,
00.46.20,94,94,188,103,0.55,0.74757,77,0.409574468,
00.46.21,56,65,121,77,0.64,0.81818,63,0.520661157,
00.46.22,63,85,148,91,0.61,0.63736,58,0.391891892,
00.46.23,68,82,150,91,0.61,0.96703,88,0.586666667,
00.47.01,530,473,1003,586,0.58,0.64846,380,0.37886341,
00.47.02,548,496,1044,619,0.59,0.6559,406,0.388888889,
00.47.03,173,175,348,175,0.5,0.64571,113,0.324712644,
00.47.04,87,83,170,102,0.6,0.69608,71,0.417647059,
00.47.05,74,81,155,88,0.57,0.56818,50,0.322580645,
00.47.06,58,55,113,57,0.5,0.78947,45,0.398230088,
00.47.07,52,48,100,53,0.53,0.71698,38,0.38,
00.47.08,62,53,115,67,0.58,0.58209,39,0.339130435,
00.47.09,22,26,48,30,0.63,0.6,18,0.375,
00.47.10,13,15,28,23,0.82,0.78261,18,0.642857143,
00.47.11,98,95,193,144,0.75,0.96528,139,0.720207254,
00.47.12,29,28,57,54,0.95,0.90741,49,0.859649123,
00.47.13,47,65,112,64,0.57,0.73438,47,0.419642857,
00.47.14,38,40,78,63,0.81,0.73016,46,0.58974359,
00.47.15,288,267,555,274,0.49,0.71168,195,0.351351351,
00.47.16,33,42,75,49,0.65,0.65306,32,0.426666667,
00.47.17,62,46,108,67,0.62,0.83582,56,0.518518519,
00.47.18,36,29,65,35,0.54,0.8,28,0.430769231,
00.47.19,24,39,63,51,0.81,0.90196,46,0.73015873,
00.47.20,324,299,623,323,0.52,0.66563,215,0.345104334,
00.47.21,45,58,103,77,0.75,0.75325,58,0.563106796,
00.47.22,108,132,240,160,0.67,0.84375,135,0.5625,
00.47.23,64,80,144,78,0.54,0.87179,68,0.472222222,
00.47.24,69,74,143,77,0.54,0.76623,59,0.412587413,
00.47.25,47,57,104,63,0.61,0.98413,62,0.596153846,
00.47.26,116,138,254,154,0.61,0.68831,106,0.417322835,
00.47.27,30,29,59,44,0.75,0.72727,32,0.542372881,
00.47.28,107,120,227,134,0.59,0.64179,86,0.378854626,
00.47.29,64,76,140,89,0.64,0.75281,67,0.478571429,
00.47.30,73,80,153,110,0.72,0.81818,90,0.588235294,
00.47.31,25,26,51,35,0.69,0.82857,29,0.568627451,
00.47.32,80,108,188,120,0.64,0.88333,106,0.563829787,
00.47.33,68,69,137,84,0.61,0.7619,64,0.467153285,
00.47.34,101,102,203,141,0.69,0.86525,122,0.600985222,
00.47.35,41,36,77,68,0.88,0.97059,66,0.857142857,
00.47.36,188,191,379,216,0.57,0.62963,136,0.35883905,
00.47.37,191,218,409,237,0.58,0.67511,160,0.391198044,
00.47.38,236,222,458,260,0.57,0.66154,172,0.375545852,
00.47.39,61,66,127,91,0.72,0.79121,72,0.566929134,
00.47.40,167,139,306,205,0.67,0.83902,172,0.562091503,
00.48.01,660,509,1169,813,0.7,0.55105,448,0.383233533,
00.48.02,391,380,771,533,0.69,0.62664,334,0.433203632,
00.48.03,283,282,565,459,0.81,0.76688,352,0.62300885,
00.48.04,355,369,724,500,0.69,0.596,298,0.41160221,
00.48.05,135,165,300,225,0.75,0.73333,165,0.55,
00.48.06,202,229,431,323,0.75,0.67802,219,0.50812065,
00.48.07,133,142,275,192,0.7,0.54688,105,0.381818182,
00.48.08,520,539,1059,810,0.76,0.72346,586,0.553352219,
00.48.09,324,343,667,432,0.65,0.8125,351,0.526236882,
00.48.10,342,364,706,520,0.74,0.60192,313,0.443342776,
00.48.11,490,537,1027,740,0.72,0.69595,515,0.501460565,
00.48.12,154,174,328,266,0.81,0.72932,194,0.591463415,
00.48.13,334,358,692,476,0.69,0.65966,314,0.453757225,
00.48.14,304,291,595,385,0.65,0.6961,268,0.450420168,
00.48.15,166,173,339,233,0.69,0.64378,150,0.442477876,
00.48.16,68,57,125,92,0.74,0.48913,45,0.36,
00.48.17,238,268,506,340,0.67,0.66176,225,0.444664032,
00.48.18,69,72,141,101,0.72,0.72277,73,0.517730496,
00.48.19,152,155,307,197,0.64,0.65482,129,0.42019544,
00.48.20,166,180,346,255,0.74,0.74902,191,0.552023121,
00.48.21,145,156,301,217,0.72,0.6682,145,0.481727575,
00.48.22,59,62,121,96,0.79,0.70833,68,0.561983471,
00.48.23,231,256,487,335,0.69,0.64179,215,0.441478439,
00.48.24,140,162,302,196,0.65,0.72449,142,0.470198675,
00.48.25,132,142,274,188,0.69,0.60638,114,0.416058394,
00.48.26,226,248,474,316,0.67,0.6519,206,0.434599156,
00.48.27,305,364,669,452,0.68,0.59735,270,0.403587444,
00.48.28,292,327,619,428,0.69,0.75,321,0.518578352,
00.48.29,395,404,799,527,0.66,0.60342,318,0.397997497,
00.48.30,481,487,968,599,0.62,0.5192,311,0.321280992,
00.48.31,296,349,645,481,0.75,0.6736,324,0.502325581,
00.48.32,217,204,421,285,0.68,0.60702,173,0.410926366,
00.48.33,357,348,705,511,0.72,0.54207,277,0.392907801,
00.48.34,87,96,183,140,0.77,0.65,91,0.49726776,
00.48.35,169,170,339,219,0.65,0.69406,152,0.448377581,
00.48.36,93,86,179,143,0.8,0.64336,92,0.51396648,
00.48.37,165,173,338,263,0.78,0.58175,153,0.452662722,
00.49.01,1253,1055,2308,1367,0.59,0.53402,730,0.316291161,
00.49.02,647,617,1264,821,0.65,0.52132,428,0.338607595,
00.49.03,573,490,1063,727,0.68,0.54746,398,0.374412041,
00.49.04,494,478,972,637,0.66,0.51962,331,0.340534979,
00.49.05,480,521,1001,707,0.71,0.55163,390,0.38961039,
00.49.06,670,680,1350,946,0.7,0.60359,571,0.422962963,
00.49.07,290,298,588,365,0.62,0.58356,213,0.362244898,
00.49.08,207,206,413,317,0.77,0.6183,196,0.474576271,
00.49.09,527,539,1066,650,0.61,0.54615,355,0.333020638,
00.49.10,244,262,506,306,0.6,0.54248,166,0.328063241,
00.49.11,651,673,1324,813,0.61,0.51169,416,0.314199396,
00.49.12,653,654,1307,725,0.55,0.57241,415,0.317521041,
00.49.13,331,335,666,445,0.67,0.6764,301,0.451951952,
00.49.14,346,353,699,497,0.71,0.57746,287,0.410586552,
00.49.15,580,647,1227,745,0.61,0.51544,384,0.312958435,
00.49.16,632,686,1318,776,0.59,0.62242,483,0.36646434,
00.49.17,276,293,569,407,0.72,0.65111,265,0.46572935,
00.49.18,550,597,1147,693,0.6,0.41847,290,0.252833479,
00.49.19,138,132,270,152,0.56,0.50658,77,0.285185185,
00.49.20,731,696,1427,902,0.63,0.48337,436,0.30553609,
00.49.21,577,550,1127,765,0.68,0.52157,399,0.354037267,
00.49.22,762,783,1545,979,0.63,0.51583,505,0.326860841,
00.49.23,541,539,1080,607,0.56,0.47282,287,0.265740741,
00.49.24,881,885,1766,1151,0.65,0.56907,655,0.370894677,
00.49.25,604,551,1155,736,0.64,0.56522,416,0.36017316,
00.49.26,700,706,1406,846,0.6,0.63475,537,0.381934566,
00.49.27,658,639,1297,855,0.66,0.56725,485,0.373939861,
00.49.28,382,414,796,586,0.74,0.61775,362,0.454773869,
00.49.29,359,327,686,475,0.69,0.69474,330,0.481049563,
00.49.30,351,338,689,426,0.62,0.58451,249,0.361393324,
00.50.01,846,678,1524,1061,0.7,0.78982,838,0.549868766,
00.50.02,49,48,97,75,0.77,0.90667,68,0.701030928,
00.50.03,753,655,1408,942,0.67,0.82059,773,0.549005682,
00.50.04,555,469,1024,756,0.74,0.77778,588,0.57421875,
00.50.05,632,481,1113,706,0.63,0.80312,567,0.509433962,
00.50.06,589,485,1074,706,0.66,0.81445,575,0.53538175,
00.50.07,217,246,463,332,0.72,0.94277,313,0.676025918,
00.50.08,402,444,846,541,0.64,0.83549,452,0.53427896,
00.50.09,75,79,154,128,0.83,0.89844,115,0.746753247,
00.50.10,885,955,1840,1318,0.72,0.86191,1136,0.617391304,
00.50.11,181,222,403,282,0.7,0.84397,238,0.59057072,
00.50.12,421,383,804,554,0.69,0.85379,473,0.588308458,
00.50.13,154,164,318,211,0.66,0.8673,183,0.575471698,
00.50.14,208,184,392,320,0.82,0.89688,287,0.732142857,
00.50.15,577,611,1188,821,0.69,0.86236,708,0.595959596,
00.50.16,333,335,668,478,0.72,0.83473,399,0.597305389,
00.50.17,292,291,583,405,0.69,0.88889,360,0.617495712,
00.50.18,423,457,880,574,0.65,0.87631,503,0.571590909,
00.50.19,552,591,1143,754,0.66,0.82095,619,0.541557305,
00.50.20,279,271,550,370,0.67,0.85946,318,0.578181818,
00.50.21,299,320,619,448,0.72,0.82366,369,0.596122779,
00.50.22,484,536,1020,671,0.66,0.81371,546,0.535294118,
00.50.23,388,389,777,509,0.66,0.83694,426,0.548262548,
00.50.24,447,420,867,566,0.65,0.83569,473,0.5455594,
00.50.25,281,271,552,397,0.72,0.82116,326,0.59057971,
00.50.26,1002,908,1910,1203,0.63,0.85536,1029,0.538743455,
00.50.27,40,41,81,71,0.88,0.91549,65,0.802469136,
00.50.28,328,333,661,494,0.75,0.89069,440,0.665658094,
00.50.29,427,385,812,647,0.8,0.95363,617,0.759852217,
00.50.30,204,207,411,277,0.67,0.81227,225,0.547445255,
00.50.31,321,328,649,460,0.71,0.87174,401,0.617873652,
00.50.32,522,482,1004,677,0.67,0.85377,578,0.575697211,
00.50.33,219,202,421,303,0.72,0.82508,250,0.593824228,
00.50.34,603,596,1199,773,0.64,0.78913,610,0.508757298,
00.50.35,150,132,282,198,0.7,0.83838,166,0.588652482,
00.50.36,869,906,1775,1201,0.68,0.8443,1014,0.571267606,
00.50.37,109,109,218,154,0.71,0.87662,135,0.619266055,
00.50.38,596,565,1161,846,0.73,0.8227,696,0.599483204,
00.50.39,564,488,1052,714,0.68,0.78992,564,0.536121673,
00.50.40,101,93,194,142,0.73,0.8662,123,0.634020619,
00.50.41,193,187,380,266,0.7,0.8797,234,0.615789474,
00.50.42,473,512,985,672,0.68,0.85714,576,0.584771574,
00.50.43,455,400,855,538,0.63,0.85316,459,0.536842105,
00.50.44,383,380,763,537,0.7,0.89944,483,0.633027523,
00.50.45,201,216,417,296,0.71,0.90203,267,0.64028777,
00.50.46,194,218,412,285,0.69,0.88421,252,0.611650485,
00.50.47,277,315,592,400,0.68,0.8775,351,0.592905405,
00.50.48,301,377,678,438,0.65,0.77169,338,0.498525074,
00.50.49,199,206,405,280,0.69,0.79286,222,0.548148148,
00.50.50,97,106,203,139,0.68,0.81295,113,0.556650246,
00.50.51,575,559,1134,731,0.64,0.85226,623,0.549382716,
00.50.52,209,208,417,293,0.7,0.84983,249,0.597122302,
00.50.53,427,395,822,527,0.64,0.85199,449,0.54622871,
00.51.01,1327,1113,2440,1375,0.56,0.53382,734,0.300819672,
00.51.02,574,527,1101,617,0.56,0.49919,308,0.279745686,
00.51.03,672,599,1271,762,0.6,0.49738,379,0.298190401,
00.51.04,1231,941,2172,1231,0.57,0.52396,645,0.296961326,
00.51.05,1161,872,2033,1134,0.56,0.49471,561,0.275946877,
00.51.06,1351,1263,2614,1493,0.57,0.50301,751,0.287299158,
00.51.07,682,560,1242,720,0.58,0.54306,391,0.314814815,
00.51.08,572,497,1069,731,0.68,0.51984,380,0.355472404,
00.51.09,768,609,1377,724,0.53,0.46685,338,0.245461147,
00.51.10,1306,1018,2324,1162,0.5,0.49053,570,0.245266781,
00.51.11,608,484,1092,628,0.58,0.53981,339,0.31043956,
00.51.12,558,718,1276,785,0.62,0.64586,507,0.397335423,
00.51.13,869,900,1769,1152,0.65,0.57986,668,0.377614471,
00.51.14,496,460,956,635,0.66,0.57795,367,0.383891213,
00.51.15,420,456,876,532,0.61,0.57143,304,0.347031963,
00.51.16,403,414,817,518,0.63,0.63127,327,0.400244798,
00.51.17,656,666,1322,724,0.55,0.59945,434,0.328290469,
00.51.18,668,689,1357,800,0.59,0.52375,419,0.308769344,
00.51.19,432,472,904,584,0.65,0.59418,347,0.383849558,
00.51.20,575,602,1177,723,0.61,0.60028,434,0.36873407,
00.51.21,449,463,912,568,0.62,0.50352,286,0.313596491,
00.51.22,669,643,1312,799,0.61,0.65457,523,0.398628049,
00.51.23,412,426,838,505,0.6,0.67327,340,0.405727924,
00.51.24,538,638,1176,686,0.58,0.57726,396,0.336734694,
00.51.25,638,549,1187,677,0.57,0.50517,342,0.288121314,
00.51.26,908,1015,1923,1150,0.6,0.57391,660,0.343213729,
00.51.27,259,280,539,348,0.65,0.57184,199,0.369202226,
00.51.28,430,460,890,578,0.65,0.7301,422,0.474157303,
00.51.29,393,482,875,582,0.67,0.59622,347,0.396571429,
00.51.30,423,494,917,573,0.62,0.66492,381,0.415485278,
00.51.31,275,297,572,343,0.6,0.68222,234,0.409090909,
00.51.32,680,724,1404,854,0.61,0.61475,525,0.373931624,
00.51.33,455,547,1002,623,0.62,0.60835,379,0.378243513,
00.51.34,626,684,1310,786,0.6,0.55852,439,0.335114504,
00.51.35,406,479,885,478,0.54,0.65481,313,0.353672316,
00.51.36,505,500,1005,645,0.64,0.48682,314,0.312437811,
00.51.37,583,551,1134,609,0.54,0.55665,339,0.298941799,
00.51.38,326,339,665,395,0.59,0.53418,211,0.317293233,
00.51.39,384,381,765,470,0.61,0.71915,338,0.441830065,
00.51.40,478,485,963,623,0.65,0.58587,365,0.379023884,
00.51.41,435,507,942,612,0.65,0.62092,380,0.403397028,
00.51.42,347,345,692,445,0.64,0.52809,235,0.339595376,
00.51.43,379,364,743,450,0.61,0.62444,281,0.378196501,
00.51.44,535,531,1066,683,0.64,0.5183,354,0.332082552,
00.52.01,606,457,1063,630,0.59,0.60794,383,0.360301035,
00.52.02,498,448,946,580,0.61,0.56379,327,0.345665962,
00.52.03,965,807,1772,1047,0.59,0.5425,568,0.320541761,
00.52.04,481,440,921,558,0.61,0.59677,333,0.361563518,
00.52.05,479,454,933,518,0.56,0.55985,290,0.310825295,
00.52.06,351,367,718,427,0.59,0.59016,252,0.35097493,
00.52.07,786,786,1572,903,0.57,0.54042,488,0.31043257,
00.52.08,248,240,488,283,0.58,0.43816,124,0.254098361,
00.52.09,725,741,1466,874,0.6,0.50458,441,0.300818554,
00.52.10,649,628,1277,773,0.61,0.55627,430,0.336726703,
00.52.11,233,208,441,295,0.67,0.57288,169,0.383219955,
00.52.12,636,606,1242,750,0.6,0.54,405,0.326086957,
00.52.13,705,603,1308,825,0.63,0.64121,529,0.404434251,
00.52.14,645,676,1321,812,0.61,0.58251,473,0.358062074,
00.52.15,461,433,894,570,0.64,0.67193,383,0.428411633,
00.52.16,434,434,868,540,0.62,0.60185,325,0.374423963,
00.52.17,214,197,411,249,0.61,0.64257,160,0.389294404,
00.52.18,162,183,345,210,0.61,0.46667,98,0.284057971,
00.52.19,106,150,256,170,0.66,0.67059,114,0.4453125,
00.52.20,295,294,589,338,0.57,0.52071,176,0.298811545,
00.52.21,107,96,203,139,0.68,0.73381,102,0.502463054,
00.52.22,151,159,310,206,0.66,0.63592,131,0.422580645,
00.52.23,310,291,601,417,0.69,0.67386,281,0.467554077,
00.52.24,400,359,759,481,0.63,0.58212,280,0.368906456,
00.53.01,1164,1125,2289,1323,0.58,0.72638,961,0.419833989,
00.53.02,1280,1134,2414,1394,0.58,0.67288,938,0.388566694,
00.53.03,475,483,958,655,0.68,0.71145,466,0.486430063,
00.53.04,613,600,1213,837,0.69,0.76822,643,0.530090684,
00.53.05,278,279,557,410,0.74,0.79268,325,0.583482944,
00.53.06,377,374,751,525,0.7,0.7181,377,0.501997337,
00.53.07,150,156,306,217,0.71,0.66359,144,0.470588235,
00.53.08,341,307,648,455,0.7,0.8,364,0.561728395,
00.53.09,275,272,547,341,0.62,0.68035,232,0.424131627,
00.53.10,286,306,592,360,0.61,0.66389,239,0.403716216,
00.53.11,141,168,309,190,0.61,0.64211,122,0.394822006,
00.53.12,708,690,1398,858,0.61,0.65967,566,0.404864092,
00.53.13,296,326,622,328,0.53,0.7378,242,0.389067524,
00.53.14,809,830,1639,964,0.59,0.70851,683,0.416717511,
00.53.15,527,490,1017,552,0.54,0.59058,326,0.320550639,
00.53.16,183,176,359,230,0.64,0.55652,128,0.356545961,
00.53.17,341,348,689,438,0.64,0.71918,315,0.457184325,
00.53.18,331,400,731,453,0.62,0.63135,286,0.39124487,
00.53.19,299,303,602,370,0.61,0.68649,254,0.42192691,
00.53.20,729,729,1458,964,0.66,0.69606,671,0.460219479,
00.53.21,692,724,1416,836,0.59,0.67584,565,0.399011299,
00.53.22,862,844,1706,1021,0.6,0.72968,745,0.436694021,
00.53.23,357,344,701,379,0.54,0.53298,202,0.288159772,
00.53.24,211,223,434,283,0.65,0.68905,195,0.449308756,
00.54.01,1307,977,2284,1291,0.57,0.6158,795,0.348073555,
00.54.02,1147,935,2082,1145,0.55,0.54236,621,0.298270893,
00.54.03,1220,929,2149,1211,0.56,0.60941,738,0.343415542,
00.54.04,1213,1069,2282,1143,0.5,0.5643,645,0.282646801,
00.54.05,1259,1143,2402,1362,0.57,0.68355,931,0.387593672,
00.54.06,622,466,1088,583,0.54,0.60549,353,0.324448529,
00.54.07,699,642,1341,790,0.59,0.67722,535,0.398956003,
00.54.08,683,572,1255,659,0.53,0.55083,363,0.289243028,
00.54.09,573,497,1070,613,0.57,0.62969,386,0.360747664,
00.54.10,662,603,1265,655,0.52,0.53282,349,0.275889328,
00.54.11,653,597,1250,565,0.45,0.59469,336,0.2688,
00.54.12,1327,1191,2518,1286,0.51,0.57232,736,0.292295473,
00.54.13,730,611,1341,739,0.55,0.61705,456,0.340044743,
00.54.14,718,560,1278,597,0.47,0.68677,410,0.320813772,
00.54.15,829,723,1552,834,0.54,0.66547,555,0.357603093,
00.54.16,950,957,1907,1203,0.63,0.67249,809,0.424226534,
00.54.17,181,204,385,256,0.66,0.60938,156,0.405194805,
00.54.18,691,660,1351,845,0.63,0.60947,515,0.381199112,
00.54.19,86,94,180,127,0.71,0.66142,84,0.466666667,
00.54.20,748,695,1443,916,0.63,0.67904,622,0.431046431,
00.54.21,234,200,434,268,0.62,0.67164,180,0.414746544,
00.54.22,522,525,1047,623,0.6,0.6549,408,0.389684814,
00.54.23,906,851,1757,1026,0.58,0.58674,602,0.342629482,
00.54.24,306,299,605,399,0.66,0.64411,257,0.424793388,
00.54.25,1123,1009,2132,1226,0.58,0.68271,837,0.392589118,
00.54.26,747,710,1457,839,0.58,0.59714,501,0.343857241,
00.54.27,461,480,941,623,0.66,0.6244,389,0.413390011,
00.54.28,579,582,1161,712,0.61,0.60955,434,0.373815676,
00.54.29,627,648,1275,779,0.61,0.69191,539,0.422745098,
00.54.30,330,353,683,384,0.56,0.64323,247,0.361639824,
00.54.31,176,147,323,208,0.64,0.72115,150,0.464396285,
00.54.32,76,71,147,100,0.68,0.67,67,0.455782313,
00.54.33,193,234,427,257,0.6,0.64202,165,0.386416862,
00.54.34,390,366,756,506,0.67,0.59486,301,0.398148148,
00.55.01,688,585,1273,792,0.62,0.65657,520,0.408483896,
00.55.02,1279,1080,2359,1314,0.56,0.62557,822,0.348452734,
00.55.03,716,571,1287,773,0.6,0.65071,503,0.390831391,
00.55.04,652,598,1250,727,0.58,0.63824,464,0.3712,
00.55.05,435,425,860,550,0.64,0.59636,328,0.381395349,
00.55.06,293,303,596,433,0.73,0.68822,298,0.5,
00.55.07,446,424,870,579,0.67,0.62176,360,0.413793103,
00.55.08,362,348,710,445,0.63,0.53483,238,0.335211268,
00.55.09,145,164,309,177,0.57,0.61582,109,0.352750809,
00.55.10,848,783,1631,1012,0.62,0.667,675,0.41385653,
00.55.11,144,168,312,233,0.75,0.72103,168,0.538461538,
00.55.12,729,675,1404,900,0.64,0.63778,574,0.408831909,
00.55.13,224,232,456,268,0.59,0.56343,151,0.331140351,
00.55.14,594,603,1197,727,0.61,0.64099,466,0.3893066,
00.55.15,112,108,220,160,0.73,0.7,112,0.509090909,
00.55.16,327,308,635,437,0.69,0.72769,318,0.500787402,
00.55.17,412,371,783,494,0.63,0.65789,325,0.415070243,
00.55.18,411,385,796,495,0.62,0.57576,285,0.358040201,
00.55.19,138,150,288,193,0.67,0.73057,141,0.489583333,
00.55.20,529,562,1091,662,0.61,0.63444,420,0.384967919,
00.55.21,196,231,427,303,0.71,0.56436,171,0.400468384,
00.55.22,154,207,361,238,0.66,0.65126,155,0.429362881,
00.55.23,28,31,59,48,0.81,0.83333,40,0.677966102,
00.55.24,49,44,93,82,0.88,0.67073,55,0.591397849,
00.55.25,711,513,1224,745,0.61,0.68322,509,0.415849673,
00.55.26,649,608,1257,776,0.62,0.67912,527,0.419252188,
00.55.27,0,0,0,154,0,0.87662,135,0,
00.56.01,1028,822,1850,1022,0.55,0.57828,591,0.319459459,
00.56.02,862,679,1541,840,0.55,0.58095,488,0.316677482,
00.56.03,971,799,1770,917,0.52,0.60305,553,0.312429379,
00.56.04,371,334,705,375,0.53,0.63467,238,0.337588652,
00.56.05,807,750,1557,849,0.55,0.65253,554,0.35581246,
00.56.06,1015,863,1878,921,0.49,0.71444,658,0.350372737,
00.56.07,892,748,1640,675,0.41,0.60148,406,0.247560976,
00.56.08,422,358,780,358,0.46,0.65922,236,0.302564103,
00.56.09,103,101,204,87,0.43,0.48276,42,0.205882353,
00.56.10,199,183,382,171,0.45,0.63743,109,0.285340314,
00.56.11,224,237,461,270,0.59,0.58519,158,0.342733189,
00.56.12,553,580,1133,660,0.58,0.72879,481,0.424536628,
00.56.13,409,450,859,520,0.61,0.67885,353,0.410942957,
00.56.14,167,220,387,258,0.67,0.82946,214,0.552971576,
00.56.15,216,239,455,288,0.63,0.71528,206,0.452747253,
00.56.16,558,673,1231,727,0.59,0.57497,418,0.339561332,
00.56.17,238,283,521,308,0.59,0.56169,173,0.332053743,
00.56.18,463,573,1036,675,0.65,0.63259,427,0.412162162,
00.56.19,578,683,1261,709,0.56,0.72073,511,0.405233941,
00.56.20,697,710,1407,830,0.59,0.69518,577,0.410092395,
00.56.21,166,194,360,215,0.6,0.70233,151,0.419444444,
00.56.22,285,334,619,371,0.6,0.56065,208,0.336025848,
00.56.23,170,172,342,222,0.65,0.6036,134,0.391812865,
00.56.24,478,498,976,576,0.59,0.69097,398,0.407786885,
00.56.25,290,300,590,338,0.57,0.6213,210,0.355932203,
00.56.26,251,293,544,381,0.7,0.69816,266,0.488970588,
00.56.27,580,599,1179,718,0.61,0.68384,491,0.416454623,
00.56.28,172,229,401,247,0.62,0.7085,175,0.436408978,
00.56.29,456,508,964,539,0.56,0.718,387,0.401452282,
00.56.30,473,530,1003,578,0.58,0.65398,378,0.376869392,
00.56.31,644,794,1438,907,0.63,0.72767,660,0.458970793,
00.56.32,275,298,573,365,0.64,0.57808,211,0.368237347,
00.56.33,573,616,1189,705,0.59,0.72482,511,0.429772918,
00.56.34,210,257,467,278,0.6,0.66906,186,0.398286938,
00.56.35,292,317,609,376,0.62,0.67021,252,0.413793103,
00.56.36,332,350,682,457,0.67,0.76586,350,0.513196481,
00.56.37,226,257,483,319,0.66,0.70846,226,0.467908903,
00.56.38,539,506,1045,648,0.62,0.62963,408,0.390430622,
00.56.39,543,644,1187,700,0.59,0.63714,446,0.375737152,
00.56.40,209,266,475,279,0.59,0.65591,183,0.385263158,
00.56.41,432,498,930,593,0.64,0.68465,406,0.43655914,
00.56.42,218,278,496,309,0.62,0.70227,217,0.4375,
00.56.43,156,182,338,227,0.67,0.56388,128,0.378698225,
00.56.44,414,440,854,602,0.7,0.64452,388,0.454332553,
00.56.45,336,380,716,429,0.6,0.61538,264,0.368715084,
00.56.46,115,128,243,187,0.77,0.68449,128,0.526748971,
00.56.47,246,270,516,312,0.6,0.66026,206,0.399224806,
00.56.48,165,194,359,234,0.65,0.64957,152,0.423398329,
00.56.49,74,91,165,105,0.64,0.53333,56,0.339393939,
00.57.01,546,537,1083,534,0.49,0.55805,298,0.275161588,
00.57.02,501,499,1000,567,0.57,0.67901,385,0.385,
00.57.03,823,711,1534,821,0.54,0.54933,451,0.294002608,
00.57.04,789,699,1488,889,0.6,0.57255,509,0.342069892,
00.57.05,977,884,1861,1022,0.55,0.5636,576,0.309511016,
00.57.06,982,841,1823,933,0.51,0.62594,584,0.32035107,
00.57.07,566,465,1031,512,0.5,0.63086,323,0.31328807,
00.57.08,304,334,638,436,0.68,0.43807,191,0.299373041,
00.57.09,159,154,313,211,0.67,0.63981,135,0.431309904,
00.57.10,251,244,495,332,0.67,0.59639,198,0.4,
00.57.11,238,256,494,334,0.68,0.6018,201,0.406882591,
00.57.12,336,337,673,470,0.7,0.67447,317,0.47102526,
00.57.13,143,119,262,181,0.69,0.60773,110,0.419847328,
00.57.14,110,114,224,165,0.74,0.63636,105,0.46875,
00.57.15,199,198,397,286,0.72,0.6993,200,0.503778338,
00.57.16,126,116,242,175,0.72,0.58857,103,0.425619835,
00.57.17,499,497,996,696,0.7,0.55747,388,0.389558233,
00.57.18,254,240,494,374,0.76,0.51604,193,0.390688259,
00.57.19,52,60,112,89,0.79,0.58427,52,0.464285714,
00.57.20,295,292,587,416,0.71,0.63702,265,0.451448041,
00.57.21,417,394,811,539,0.66,0.52134,281,0.34648582,
00.57.22,226,189,415,281,0.68,0.5694,160,0.385542169,
00.57.23,219,208,427,294,0.69,0.58503,172,0.402810304,
00.57.24,88,103,191,120,0.63,0.60833,73,0.382198953,
00.57.25,149,158,307,197,0.64,0.63452,125,0.407166124,
00.57.26,101,95,196,158,0.81,0.55063,87,0.443877551,
00.57.27,189,177,366,258,0.7,0.64729,167,0.456284153,
00.57.28,17,28,45,44,0.98,0.45455,20,0.444444444,
00.57.29,282,297,579,349,0.6,0.59885,209,0.360967185,
00.57.30,62,60,122,86,0.7,0.67442,58,0.475409836,
00.57.31,424,390,814,410,0.5,0.6122,251,0.308353808,
00.58.01,1139,878,2017,1119,0.55,0.51385,575,0.285076847,
00.58.02,781,608,1389,725,0.52,0.54759,397,0.285817135,
00.58.03,1316,1000,2316,1244,0.54,0.48473,603,0.260362694,
00.58.04,1100,905,2005,1106,0.55,0.49277,545,0.271820449,
00.58.05,1159,842,2001,1110,0.55,0.58108,645,0.322338831,
00.58.06,1073,877,1950,1101,0.56,0.52952,583,0.298974359,
00.58.07,598,704,1302,604,0.46,0.61424,371,0.284946237,
00.58.08,565,555,1120,709,0.63,0.622,441,0.39375,
00.58.09,270,249,519,294,0.57,0.4932,145,0.27938343,
00.58.10,275,282,557,300,0.54,0.53,159,0.28545781,
00.58.11,532,495,1027,624,0.61,0.60256,376,0.366114898,
00.58.12,219,202,421,251,0.6,0.53386,134,0.318289786,
00.58.13,170,166,336,232,0.69,0.55603,129,0.383928571,
00.58.14,370,350,720,444,0.62,0.59459,264,0.366666667,
00.58.15,596,632,1228,734,0.6,0.58174,427,0.34771987,
00.58.16,654,645,1299,737,0.57,0.62415,460,0.354118553,
00.58.17,315,318,633,408,0.64,0.60539,247,0.390205371,
00.58.18,438,385,823,450,0.55,0.52,234,0.284325638,
00.58.19,72,99,171,89,0.52,0.67416,60,0.350877193,
00.58.20,209,207,416,249,0.6,0.64659,161,0.387019231,
00.58.21,94,95,189,144,0.76,0.77083,111,0.587301587,
00.58.22,98,125,223,156,0.7,0.69231,108,0.484304933,
00.58.23,812,805,1617,914,0.57,0.57002,521,0.322201608,
00.58.24,638,624,1262,657,0.52,0.57078,375,0.297147385,
00.58.25,443,476,919,545,0.59,0.64037,349,0.379760609,
00.58.26,543,477,1020,656,0.64,0.53811,353,0.346078431,
00.58.27,280,251,531,310,0.58,0.55806,173,0.325800377,
00.58.28,116,108,224,171,0.76,0.67251,115,0.513392857,
00.58.29,59,55,114,76,0.67,0.67105,51,0.447368421,
00.58.30,158,165,323,197,0.61,0.54822,108,0.334365325,
00.58.31,292,277,569,360,0.63,0.625,225,0.39543058,
00.58.32,183,176,359,223,0.62,0.55605,124,0.3454039,
00.58.33,108,114,222,145,0.65,0.5931,86,0.387387387,
00.58.34,390,383,773,459,0.59,0.61656,283,0.36610608,
00.58.35,442,412,854,517,0.61,0.56673,293,0.343091335,
00.58.36,653,598,1251,652,0.52,0.56442,368,0.294164668,
00.58.37,445,432,877,542,0.62,0.5738,311,0.354618016,
00.58.38,544,507,1051,624,0.59,0.64103,400,0.380589914,
00.58.39,168,175,343,219,0.64,0.62557,137,0.39941691,
00.58.40,151,133,284,184,0.65,0.56522,104,0.366197183,
00.58.41,41,64,105,69,0.66,0.65217,45,0.428571429,
00.58.42,373,357,730,483,0.66,0.77019,372,0.509589041,
00.58.43,316,253,569,376,0.66,0.81915,308,0.541300527,
00.58.44,620,639,1259,703,0.56,0.55477,390,0.309769658,
00.58.45,490,387,877,363,0.41,0.42975,156,0.177879133,
00.58.46,552,516,1068,572,0.54,0.57343,328,0.307116105,
00.58.47,415,474,889,507,0.57,0.53452,271,0.304836895,
00.58.48,635,579,1214,738,0.61,0.63957,472,0.388797364,
00.58.49,473,432,905,513,0.57,0.58285,299,0.33038674,
00.58.50,373,375,748,477,0.64,0.6457,308,0.411764706,
00.58.51,350,361,711,428,0.6,0.56308,241,0.338959212,
00.58.52,351,403,754,468,0.62,0.56838,266,0.352785146,
00.58.53,609,489,1098,614,0.56,0.5342,328,0.298724954,
00.58.54,226,231,457,317,0.69,0.57098,181,0.396061269,
00.58.55,470,483,953,531,0.56,0.49906,265,0.278069255,
00.58.56,353,389,742,405,0.55,0.50617,205,0.276280323,
00.58.57,492,380,872,479,0.55,0.53445,256,0.293577982,
00.58.58,0,0,0,200,0,0.945,189,0,
00.59.01,510,400,910,550,0.6,0.62182,342,0.375824176,
00.59.02,1449,1127,2576,1333,0.52,0.47787,637,0.247282609,
00.59.03,575,501,1076,595,0.55,0.46555,277,0.257434944,
00.59.04,1325,1060,2385,1161,0.49,0.42377,492,0.206289308,
00.59.05,1320,1096,2416,1207,0.5,0.42254,510,0.211092715,
00.59.06,1138,984,2122,1175,0.55,0.42723,502,0.236569274,
00.59.07,1159,958,2117,1192,0.56,0.44547,531,0.250826641,
00.59.08,1673,1271,2944,1529,0.52,0.48332,739,0.251019022,
00.59.09,817,594,1411,851,0.6,0.54877,467,0.330970943,
00.59.10,675,539,1214,760,0.63,0.52105,396,0.326194399,
00.59.11,810,598,1408,804,0.57,0.51119,411,0.291903409,
00.59.12,767,619,1386,796,0.57,0.5,398,0.287157287,
00.59.13,1477,1255,2732,1508,0.55,0.47414,715,0.261713031,
00.59.14,1229,1013,2242,1259,0.56,0.444,559,0.249330955,
00.59.15,773,609,1382,826,0.6,0.47942,396,0.286541245,
00.59.16,1378,1091,2469,1444,0.58,0.44945,649,0.262859457,
00.59.17,1674,1317,2991,1623,0.54,0.46765,759,0.253761284,
00.59.18,1157,938,2095,1136,0.54,0.46655,530,0.252983294,
00.59.19,618,455,1073,517,0.48,0.58994,305,0.284249767,
00.59.20,872,748,1620,894,0.55,0.55593,497,0.306790123,
00.59.21,1352,1147,2499,1363,0.55,0.51724,705,0.282112845,
00.59.22,1520,1280,2800,1504,0.54,0.50665,762,0.272142857,
00.59.23,1632,1179,2811,1651,0.59,0.50636,836,0.297403059,
00.59.24,1624,1330,2954,1613,0.55,0.47365,764,0.258632363,
00.59.25,1451,1140,2591,1410,0.54,0.46879,661,0.255113856,
00.59.26,1274,921,2195,1236,0.56,0.5,618,0.281548975,
00.59.27,1690,1270,2960,1500,0.51,0.47733,716,0.241891892,
00.59.28,1004,721,1725,941,0.55,0.51222,482,0.27942029,
00.59.29,1586,1161,2747,1423,0.52,0.44694,636,0.2315253,
00.59.30,866,582,1448,823,0.57,0.51154,421,0.290745856,
00.59.31,1541,1085,2626,1327,0.51,0.47551,631,0.240289414,
00.59.32,1583,1234,2817,1422,0.5,0.42546,605,0.214767483,
00.59.33,1642,1245,2887,1414,0.49,0.41938,593,0.205403533,
00.59.34,768,551,1319,674,0.51,0.35163,237,0.179681577,
00.59.35,1238,979,2217,1097,0.49,0.44941,493,0.222372576,
00.59.36,1584,1266,2850,1440,0.51,0.44097,635,0.222807018,
00.59.37,1433,1140,2573,1296,0.5,0.50694,657,0.255343956,
00.59.38,1243,1256,2499,1235,0.49,0.46964,580,0.232092837,
00.59.39,521,456,977,576,0.59,0.49132,283,0.289662231,
00.59.40,1175,983,2158,1090,0.51,0.48624,530,0.245597776,
00.59.41,1551,1237,2788,1541,0.55,0.49254,759,0.272238164,
00.59.42,1477,1237,2714,1532,0.56,0.4765,730,0.268975682,
00.59.43,1486,1143,2629,1271,0.48,0.43273,550,0.209205021,
00.59.44,1517,1187,2704,1399,0.52,0.396,554,0.204881657,
00.59.45,1303,1000,2303,1126,0.49,0.38099,429,0.186278767,
00.59.46,927,703,1630,818,0.5,0.47677,390,0.239263804,
00.59.47,1415,1145,2560,1242,0.49,0.44767,556,0.2171875,
00.59.48,1205,957,2162,993,0.46,0.52165,518,0.239592969,
00.59.49,1306,1044,2350,1111,0.47,0.46985,522,0.22212766,
00.59.50,610,457,1067,530,0.5,0.48302,256,0.239925023,
00.59.51,702,534,1236,649,0.53,0.57473,373,0.301779935,
00.59.52,1415,1130,2545,1367,0.54,0.52012,711,0.279371316,
00.59.53,1429,1079,2508,1235,0.49,0.48016,593,0.236443381,
00.59.54,1340,1079,2419,1231,0.51,0.50853,626,0.258784622,
00.59.55,1155,902,2057,1029,0.5,0.4276,440,0.213903743,
00.59.56,1331,1040,2371,1193,0.5,0.47527,567,0.239139604,
00.59.57,1581,1208,2789,1446,0.52,0.4343,628,0.225170312,
00.59.58,1316,1022,2338,1232,0.53,0.43912,541,0.231394354,
00.59.59,1520,1178,2698,1366,0.51,0.42679,583,0.21608599,
00.59.60,1477,1163,2640,1340,0.51,0.47463,636,0.240909091,
00.59.61,1122,859,1981,961,0.49,0.48907,470,0.237253912,
00.59.62,1425,1119,2544,1300,0.51,0.48615,632,0.248427673,
00.59.63,1392,1068,2460,1402,0.57,0.44793,628,0.255284553,
00.59.64,1224,990,2214,1215,0.55,0.53909,655,0.295844625,
00.59.65,1308,1036,2344,1272,0.54,0.45755,582,0.248293515,
00.59.66,822,635,1457,834,0.57,0.43645,364,0.249828415,
00.59.67,783,686,1469,800,0.54,0.4425,354,0.240980259,
00.59.68,849,574,1423,753,0.53,0.46348,349,0.2452565,
00.59.69,613,481,1094,547,0.5,0.50457,276,0.252285192,
00.59.70,818,606,1424,752,0.53,0.45612,343,0.240870787,
00.59.71,717,649,1366,801,0.59,0.49438,396,0.289897511,
00.59.72,0,0,0,209,0,0.87081,182,0,
00.60.01,707,586,1293,818,0.63,0.66993,548,0.423820572,
00.60.02,1218,1064,2282,1422,0.62,0.59916,852,0.373356705,
00.60.03,1147,886,2033,1253,0.62,0.65044,815,0.400885391,
00.60.04,567,440,1007,619,0.61,0.59935,371,0.368421053,
00.60.05,1351,1012,2363,1393,0.59,0.54487,759,0.321201862,
00.60.06,1063,879,1942,1318,0.68,0.68134,898,0.462409887,
00.60.07,1185,936,2121,1185,0.56,0.62025,735,0.346534653,
00.60.08,1208,1257,2465,1372,0.56,0.65962,905,0.367139959,
00.60.09,903,928,1831,1149,0.63,0.53351,613,0.334789732,
00.60.10,389,334,723,518,0.72,0.78958,409,0.565698479,
00.60.11,187,154,341,230,0.67,0.65217,150,0.439882698,
00.60.12,952,1030,1982,1217,0.61,0.60066,731,0.368819374,
00.60.13,469,492,961,550,0.57,0.69091,380,0.395421436,
00.60.14,436,443,879,584,0.66,0.7363,430,0.489192264,
00.60.15,625,621,1246,836,0.67,0.59091,494,0.3964687,
00.60.16,401,399,800,553,0.69,0.62568,346,0.4325,
00.60.17,732,654,1386,835,0.6,0.68024,568,0.40981241,
00.60.18,919,877,1796,1046,0.58,0.63767,667,0.371380846,
00.60.19,506,467,973,683,0.7,0.70132,479,0.492291881,
00.60.20,494,451,945,641,0.68,0.69267,444,0.46984127,
00.60.21,544,501,1045,621,0.59,0.6715,417,0.399043062,
00.60.22,358,338,696,428,0.61,0.73131,313,0.449712644,
00.60.23,567,582,1149,696,0.61,0.75718,527,0.458659704,
00.60.24,1024,952,1976,1264,0.64,0.64873,820,0.414979757,
00.60.25,733,731,1464,959,0.66,0.66215,635,0.433743169,
00.60.26,572,558,1130,728,0.64,0.68819,501,0.443362832,
00.60.27,1036,1038,2074,1131,0.55,0.59947,678,0.326904532,
00.60.28,335,307,642,377,0.59,0.72944,275,0.42834891,
00.60.29,317,336,653,470,0.72,0.67234,316,0.483920368,
00.60.30,426,392,818,520,0.64,0.65769,342,0.41809291,
00.60.31,579,572,1151,648,0.56,0.59259,384,0.333622937,
00.60.32,522,564,1086,626,0.58,0.71406,447,0.41160221,
00.60.33,657,668,1325,833,0.63,0.64946,541,0.408301887,
00.60.34,385,417,802,517,0.64,0.70213,363,0.452618454,
00.60.35,1026,892,1918,1185,0.62,0.62025,735,0.383211679,
00.60.36,264,255,519,345,0.66,0.70435,243,0.468208092,
00.60.37,635,677,1312,725,0.55,0.64138,465,0.354420732,
00.60.38,685,710,1395,895,0.64,0.6905,618,0.443010753,
00.60.39,743,694,1437,885,0.62,0.61356,543,0.377870564,
00.60.40,697,683,1380,902,0.65,0.60976,550,0.398550725,
00.60.41,373,394,767,535,0.7,0.63738,341,0.444589309,
00.60.42,461,465,926,581,0.63,0.66609,387,0.417926566,
00.60.43,446,337,783,494,0.63,0.60931,301,0.384418902,
00.60.44,304,347,651,343,0.53,0.69388,238,0.365591398,
00.60.45,915,905,1820,1026,0.56,0.66569,683,0.375274725,
00.60.46,0,0,0,127,0,0.82677,105,0,
00.61.01,737,644,1381,825,0.6,0.61576,508,0.367849385,
00.61.02,1287,1043,2330,1297,0.56,0.58443,758,0.325321888,
00.61.03,1142,964,2106,1197,0.57,0.61654,738,0.35042735,
00.61.04,477,479,956,593,0.62,0.6796,403,0.421548117,
00.61.05,173,202,375,237,0.63,0.59072,140,0.373333333,
00.61.06,408,402,810,572,0.71,0.7028,402,0.496296296,
00.61.07,468,442,910,565,0.62,0.51858,293,0.321978022,
00.61.08,595,592,1187,764,0.64,0.64136,490,0.412805392,
00.61.09,396,415,811,487,0.6,0.65092,317,0.390875462,
00.61.10,336,357,693,434,0.63,0.52765,229,0.33044733,
00.61.11,704,683,1387,865,0.62,0.6578,569,0.410237924,
00.61.12,376,382,758,481,0.63,0.64449,310,0.408970976,
00.61.13,264,269,533,350,0.66,0.64857,227,0.425891182,
00.61.14,421,385,806,502,0.62,0.60159,302,0.374689826,
00.61.15,161,162,323,210,0.65,0.69048,145,0.448916409,
00.61.16,176,183,359,227,0.63,0.70925,161,0.448467967,
00.61.17,254,226,480,324,0.68,0.60185,195,0.40625,
00.61.18,294,333,627,374,0.6,0.4893,183,0.291866029,
00.61.19,436,393,829,467,0.56,0.46895,219,0.264173703,
00.61.20,612,542,1154,700,0.61,0.59571,417,0.36135182,
00.61.21,644,682,1326,736,0.56,0.6019,443,0.334087481,
00.61.22,486,432,918,586,0.64,0.72355,424,0.461873638,
00.61.23,760,720,1480,912,0.62,0.66009,602,0.406756757,
00.61.24,650,672,1322,819,0.62,0.56288,461,0.34871407,
00.61.25,225,234,459,267,0.58,0.62172,166,0.361655773,
00.61.26,142,144,286,174,0.61,0.48276,84,0.293706294,
00.61.27,276,296,572,336,0.59,0.56845,191,0.333916084,
00.61.28,213,270,483,290,0.6,0.57241,166,0.3436853,
00.61.29,170,171,341,218,0.64,0.56881,124,0.363636364,
00.61.30,325,299,624,372,0.6,0.61559,229,0.366987179,
00.61.31,303,325,628,384,0.61,0.54688,210,0.334394904,
00.62.01,913,792,1705,1144,0.67,0.63462,726,0.425806452,
00.62.02,336,325,661,442,0.67,0.6086,269,0.406959153,
00.62.03,229,241,470,316,0.67,0.59177,187,0.39787234,
00.62.04,387,380,767,472,0.62,0.69492,328,0.427640156,
00.62.05,275,276,551,406,0.74,0.65764,267,0.484573503,
00.62.06,430,419,849,568,0.67,0.79225,450,0.530035336,
00.62.07,315,312,627,390,0.62,0.64872,253,0.403508772,
00.62.08,55,46,101,75,0.74,0.74667,56,0.554455446,
00.62.09,191,185,376,225,0.6,0.63111,142,0.377659574,
00.62.10,157,171,328,241,0.73,0.6473,156,0.475609756,
00.62.11,110,140,250,172,0.69,0.57558,99,0.396,
00.62.12,101,112,213,150,0.7,0.65333,98,0.460093897,
00.62.13,134,149,283,210,0.74,0.64762,136,0.480565371,
00.62.14,114,134,248,178,0.72,0.60112,107,0.431451613,
00.62.15,456,460,916,651,0.71,0.60061,391,0.426855895,
00.62.16,413,391,804,562,0.7,0.74199,417,0.518656716,
00.62.17,104,124,228,170,0.75,0.79412,135,0.592105263,
00.62.18,105,90,195,150,0.77,0.82667,124,0.635897436,
00.62.19,158,151,309,172,0.56,0.59302,102,0.330097087,
00.62.20,142,153,295,210,0.71,0.75714,159,0.538983051,
00.62.21,155,165,320,242,0.76,0.73554,178,0.55625,
00.62.22,306,332,638,367,0.58,0.6376,234,0.36677116,
00.62.23,349,338,687,485,0.71,0.76907,373,0.54294032,
00.62.24,253,264,517,385,0.74,0.72468,279,0.539651838,
00.62.25,447,431,878,513,0.58,0.63743,327,0.372437358,
00.62.26,264,256,520,390,0.75,0.6359,248,0.476923077,
00.62.27,347,314,661,451,0.68,0.6541,295,0.446293495,
00.62.28,99,85,184,126,0.68,0.73016,92,0.5,
00.62.29,443,456,899,604,0.67,0.67053,405,0.450500556,
00.62.30,195,214,409,276,0.67,0.67754,187,0.457212714,
00.62.31,484,465,949,575,0.61,0.67826,390,0.410958904,
00.62.32,64,60,124,90,0.73,0.67778,61,0.491935484,
00.62.33,212,192,404,258,0.64,0.5814,150,0.371287129,
00.63.01,1084,858,1942,1147,0.59,0.62337,715,0.368177137,
00.63.02,886,749,1635,1046,0.64,0.6262,655,0.400611621,
00.63.03,717,638,1355,839,0.62,0.63051,529,0.390405904,
00.63.04,242,281,523,364,0.7,0.66758,243,0.464627151,
00.63.05,470,503,973,665,0.68,0.6406,426,0.437821172,
00.63.06,370,395,765,516,0.67,0.62403,322,0.420915033,
00.63.07,793,693,1486,920,0.62,0.64891,597,0.401749664,
00.63.08,430,437,867,548,0.63,0.60584,332,0.382929642,
00.63.09,574,532,1106,697,0.63,0.5868,409,0.369801085,
00.63.10,271,276,547,371,0.68,0.71429,265,0.484460695,
00.63.11,655,645,1300,809,0.62,0.70457,570,0.438461538,
00.63.12,532,575,1107,720,0.65,0.5375,387,0.349593496,
00.63.13,343,372,715,441,0.62,0.52834,233,0.325874126,
00.63.14,497,460,957,557,0.58,0.59964,334,0.349007315,
00.63.15,331,328,659,437,0.66,0.61785,270,0.409711684,
00.63.16,466,448,914,607,0.66,0.55354,336,0.36761488,
00.63.17,469,461,930,588,0.63,0.59864,352,0.378494624,
00.63.18,323,362,685,466,0.68,0.68026,317,0.462773723,
00.63.19,250,235,485,296,0.61,0.56081,166,0.342268041,
00.63.20,404,372,776,499,0.64,0.5992,299,0.385309278,
00.64.01,1080,851,1931,1069,0.55,0.48644,520,0.269290523,
00.64.02,510,416,926,554,0.6,0.53791,298,0.321814255,
00.64.03,539,447,986,567,0.58,0.5679,322,0.326572008,
00.64.04,540,424,964,564,0.59,0.51241,289,0.299792531,
00.64.05,581,440,1021,517,0.51,0.51064,264,0.258570029,
00.64.06,282,245,527,310,0.59,0.49677,154,0.292220114,
00.64.07,673,576,1249,763,0.61,0.51769,395,0.316253002,
00.64.08,741,650,1391,764,0.55,0.42277,323,0.232207045,
00.64.09,713,652,1365,745,0.55,0.49933,372,0.272527473,
00.64.10,658,535,1193,676,0.57,0.56805,384,0.321877619,
00.64.11,408,319,727,404,0.56,0.49257,199,0.273727648,
00.64.12,718,593,1311,716,0.55,0.53352,382,0.291380625,
00.64.13,779,684,1463,726,0.5,0.51928,377,0.257689679,
00.64.14,1273,1014,2287,1178,0.52,0.44822,528,0.230870136,
00.64.15,1370,1160,2530,1378,0.54,0.45646,629,0.248616601,
00.64.16,1180,994,2174,1118,0.51,0.46512,520,0.239190432,
00.64.17,642,654,1296,774,0.6,0.52067,403,0.31095679,
00.64.18,415,395,810,553,0.68,0.40325,223,0.275308642,
00.64.19,241,267,508,344,0.68,0.59593,205,0.403543307,
00.64.20,462,500,962,642,0.67,0.58879,378,0.392931393,
00.64.21,231,227,458,317,0.69,0.66246,210,0.458515284,
00.64.22,711,638,1349,800,0.59,0.515,412,0.305411416,
00.64.23,256,251,507,328,0.65,0.47866,157,0.309664694,
00.64.24,330,312,642,452,0.7,0.50664,229,0.356697819,
00.64.25,99,98,197,121,0.61,0.60331,73,0.370558376,
00.64.26,475,480,955,605,0.63,0.52231,316,0.330890052,
00.64.27,996,933,1929,1089,0.56,0.54821,597,0.309486781,
00.64.28,540,532,1072,636,0.59,0.55031,350,0.326492537,
00.64.29,298,288,586,422,0.72,0.6019,254,0.433447099,
00.64.30,284,283,567,370,0.65,0.51081,189,0.333333333,
00.64.31,338,309,647,373,0.58,0.58981,220,0.340030912,
00.64.32,688,654,1342,809,0.6,0.58096,470,0.350223547,
00.64.33,387,368,755,433,0.57,0.57968,251,0.332450331,
00.64.34,324,284,608,395,0.65,0.60253,238,0.391447368,
00.64.35,248,260,508,320,0.63,0.65625,210,0.413385827,
00.64.36,191,227,418,260,0.62,0.71923,187,0.447368421,
00.65.01,773,753,1526,917,0.6,0.47328,434,0.28440367,
00.65.02,898,754,1652,1011,0.61,0.57666,583,0.352905569,
00.65.03,642,626,1268,841,0.66,0.59215,498,0.392744479,
00.65.04,541,475,1016,610,0.6,0.57705,352,0.346456693,
00.65.05,293,275,568,339,0.6,0.55752,189,0.332746479,
00.65.06,478,558,1036,651,0.63,0.60522,394,0.38030888,
00.65.07,287,306,593,372,0.63,0.46237,172,0.29005059,
00.65.08,282,257,539,350,0.65,0.54857,192,0.356215213,
00.65.09,491,486,977,605,0.62,0.54711,331,0.338792221,
00.65.10,411,403,814,526,0.65,0.48479,255,0.313267813,
00.65.11,350,340,690,487,0.71,0.42916,209,0.302898551,
00.65.12,331,369,700,500,0.71,0.47,235,0.335714286,
00.65.13,646,623,1269,780,0.61,0.52436,409,0.322301024,
00.65.14,348,409,757,473,0.62,0.57082,270,0.35667107,
00.65.15,263,269,532,398,0.75,0.87186,347,0.652255639,
00.65.16,174,186,360,315,0.88,0.87937,277,0.769444444,
00.65.17,376,351,727,407,0.56,0.59459,242,0.332874828,
00.65.18,413,434,847,501,0.59,0.58084,291,0.343565525,
00.65.19,414,410,824,530,0.64,0.5,265,0.321601942,
00.65.20,223,256,479,317,0.66,0.47003,149,0.311064718,
00.65.21,572,602,1174,698,0.59,0.58023,405,0.344974446,
00.65.22,301,306,607,408,0.67,0.5,204,0.336079077,
00.65.23,213,242,455,316,0.69,0.45253,143,0.314285714,
00.65.24,165,202,367,231,0.63,0.59307,137,0.373297003,
00.65.25,421,447,868,571,0.66,0.59019,337,0.388248848,
00.65.26,684,693,1377,821,0.6,0.53593,440,0.319535221,
00.65.27,428,458,886,525,0.59,0.66286,348,0.392776524,
00.65.28,339,357,696,474,0.68,0.48101,228,0.327586207,
00.65.29,348,352,700,489,0.7,0.47853,234,0.334285714,
00.65.30,560,536,1096,681,0.62,0.56681,386,0.352189781,
00.65.31,342,320,662,466,0.7,0.56009,261,0.394259819,
00.65.32,624,647,1271,723,0.57,0.47441,343,0.269866247,
00.65.33,596,625,1221,739,0.61,0.5318,393,0.321867322,
00.65.34,504,476,980,717,0.73,0.6848,491,0.501020408,
00.65.35,629,659,1288,758,0.59,0.52507,398,0.309006211,
00.66.01,1303,1019,2322,1292,0.56,0.56656,732,0.315245478,
00.66.02,1030,932,1962,1120,0.57,0.58304,653,0.332823649,
00.66.03,1217,1169,2386,1402,0.59,0.64194,900,0.377200335,
00.66.04,684,722,1406,842,0.6,0.52732,444,0.315789474,
00.66.05,541,596,1137,661,0.58,0.57791,382,0.335971856,
00.66.06,288,278,566,390,0.69,0.45897,179,0.316254417,
00.66.07,784,808,1592,950,0.6,0.52632,500,0.314070352,
00.66.08,377,366,743,430,0.58,0.59535,256,0.344549125,
00.66.09,229,232,461,285,0.62,0.65965,188,0.407809111,
00.66.10,425,415,840,503,0.6,0.56262,283,0.336904762,
00.66.11,1001,988,1989,1161,0.58,0.5814,675,0.339366516,
00.66.12,300,287,587,419,0.71,0.68019,285,0.485519591,
00.66.13,716,693,1409,919,0.65,0.5876,540,0.383250532,
00.66.14,174,208,382,255,0.67,0.72941,186,0.486910995,
00.66.15,939,944,1883,1138,0.6,0.52548,598,0.317578332,
00.66.16,141,188,329,224,0.68,0.47768,107,0.325227964,
00.66.17,197,223,420,316,0.75,0.75949,240,0.571428571,
00.66.18,308,264,572,426,0.74,0.53991,230,0.402097902,
00.66.19,728,708,1436,797,0.56,0.6123,488,0.339832869,
00.66.20,264,274,538,350,0.65,0.60286,211,0.392193309,
00.66.21,782,823,1605,909,0.57,0.58526,532,0.331464174,
00.66.22,124,115,239,167,0.7,0.62874,105,0.439330544,
00.66.23,528,570,1098,682,0.62,0.55718,380,0.346083789,
00.66.24,285,313,598,386,0.65,0.5285,204,0.341137124,
00.67.01,1065,860,1925,1046,0.54,0.49522,518,0.269090909,
00.67.02,1197,1019,2216,1056,0.48,0.51515,544,0.245487365,
00.67.03,599,496,1095,601,0.55,0.56905,342,0.312328767,
00.67.04,311,255,566,332,0.59,0.57229,190,0.335689046,
00.67.05,1008,842,1850,767,0.41,0.48631,373,0.201621622,
00.67.06,1575,1419,2994,1239,0.41,0.45682,566,0.189044756,
00.67.07,1445,1109,2554,1256,0.49,0.43312,544,0.212999217,
00.67.08,1216,1037,2253,1078,0.48,0.47124,508,0.225477142,
00.67.09,1238,1070,2308,1153,0.5,0.50217,579,0.250866551,
00.67.10,1167,918,2085,1032,0.49,0.48934,505,0.242206235,
00.67.11,1240,961,2201,1018,0.46,0.47446,483,0.219445706,
00.67.12,1495,1210,2705,1263,0.47,0.47189,596,0.220332717,
00.67.13,786,662,1448,784,0.54,0.52296,410,0.283149171,
00.67.14,784,656,1440,666,0.46,0.4985,332,0.230555556,
00.67.15,1298,1058,2356,1004,0.43,0.48008,482,0.204584041,
00.67.16,1449,1179,2628,1181,0.45,0.46232,546,0.207762557,
00.67.17,1513,1250,2763,1204,0.44,0.46013,554,0.200506696,
00.67.18,1614,1183,2797,965,0.35,0.43005,415,0.148373257,
00.67.19,660,550,1210,600,0.5,0.50667,304,0.251239669,
00.67.20,1346,1067,2413,1081,0.45,0.46438,502,0.208039785,
00.67.21,1101,908,2009,891,0.44,0.46465,414,0.206072673,
00.67.22,1191,983,2174,586,0.27,0.46928,275,0.12649494,
00.67.23,1640,1420,3060,1244,0.41,0.50804,632,0.206535948,
00.67.24,1330,1083,2413,903,0.37,0.43632,394,0.163282221,
00.67.25,581,599,1180,686,0.58,0.58746,403,0.341525424,
00.67.26,583,520,1103,546,0.5,0.51648,282,0.255666364,
00.67.27,291,260,551,259,0.47,0.54054,140,0.254083485,
00.67.28,1267,1158,2425,977,0.4,0.58854,575,0.237113402,
00.67.29,649,638,1287,636,0.49,0.59591,379,0.294483294,
00.67.30,1043,968,2011,929,0.46,0.53175,494,0.245648931,
00.67.31,616,613,1229,633,0.52,0.58926,373,0.303498779,
00.67.32,535,484,1019,438,0.43,0.44977,197,0.193326791,
00.67.33,265,270,535,290,0.54,0.44483,129,0.241121495,
00.67.34,246,278,524,322,0.61,0.49689,160,0.305343511,
00.67.35,1271,1152,2423,1111,0.46,0.53645,596,0.245976063,
00.67.36,314,297,611,325,0.53,0.48615,158,0.258592471,
00.67.37,467,448,915,490,0.54,0.57143,280,0.306010929,
00.67.38,515,526,1041,658,0.63,0.54863,361,0.34678194,
00.67.39,545,516,1061,593,0.56,0.52445,311,0.293119698,
00.67.40,1359,1271,2630,1084,0.41,0.41882,454,0.172623574,
00.67.41,1290,1153,2443,1132,0.46,0.51325,581,0.23782235,
00.67.42,1302,1221,2523,1054,0.42,0.43643,460,0.182322632,
00.67.43,814,744,1558,775,0.5,0.51742,401,0.257381258,
00.67.44,846,829,1675,790,0.47,0.49747,393,0.234626866,
00.67.45,974,922,1896,1092,0.58,0.52015,568,0.299578059,
00.67.46,724,648,1372,712,0.52,0.57022,406,0.295918367,
00.67.47,700,691,1391,818,0.59,0.59046,483,0.347232207,
00.67.48,715,712,1427,745,0.52,0.54497,406,0.284512964,
00.67.49,458,479,937,452,0.48,0.60841,275,0.293489861,
00.67.50,697,738,1435,658,0.46,0.45137,297,0.206968641,
00.67.51,631,584,1215,557,0.46,0.52244,291,0.239506173,
00.67.52,548,577,1125,663,0.59,0.53243,353,0.313777778,
00.67.53,872,885,1757,826,0.47,0.523,432,0.245873648,
00.67.54,1006,969,1975,990,0.5,0.48687,482,0.244050633,
00.67.55,1369,1309,2678,965,0.36,0.49016,473,0.176624347,
00.67.56,313,283,596,238,0.4,0.57563,137,0.229865772,
00.67.57,781,631,1412,522,0.37,0.4272,223,0.157932011,
00.67.58,375,362,737,431,0.58,0.58469,252,0.34192673,
00.67.59,647,637,1284,716,0.56,0.60615,434,0.338006231,
00.67.60,918,891,1809,873,0.48,0.55899,488,0.2697623,
00.67.61,469,462,931,535,0.57,0.63364,339,0.364124597,
00.67.62,493,437,930,397,0.43,0.63728,253,0.272043011,
00.67.63,872,824,1696,739,0.44,0.56292,416,0.245283019,
00.67.64,469,427,896,445,0.5,0.49888,222,0.247767857,
00.67.65,884,850,1734,889,0.51,0.53431,475,0.273933103,
00.67.66,588,567,1155,616,0.53,0.5276,325,0.281385281,
00.67.67,785,708,1493,735,0.49,0.53333,392,0.262558607,
00.67.68,1014,851,1865,827,0.44,0.48247,399,0.213941019,
00.67.69,721,686,1407,720,0.51,0.69306,499,0.354655295,
00.67.70,794,814,1608,902,0.56,0.46563,420,0.26119403,
00.68.01,726,591,1317,826,0.63,0.46731,386,0.293090357,
00.68.02,576,554,1130,712,0.63,0.49298,351,0.310619469,
00.68.03,1327,1159,2486,1492,0.6,0.47788,713,0.286806114,
00.68.04,229,191,420,242,0.58,0.45041,109,0.25952381,
00.68.05,507,472,979,560,0.57,0.58571,328,0.335035751,
00.68.06,1136,1082,2218,881,0.4,0.39387,347,0.15644725,
00.68.07,1188,949,2137,796,0.37,0.4108,327,0.15301825,
00.68.08,358,336,694,464,0.67,0.48922,227,0.327089337,
00.68.09,703,702,1405,718,0.51,0.49721,357,0.254092527,
00.68.10,591,577,1168,617,0.53,0.4684,289,0.247431507,
00.68.11,285,260,545,368,0.68,0.51902,191,0.350458716,
00.68.12,373,377,750,521,0.69,0.47985,250,0.333333333,
00.68.13,296,313,609,347,0.57,0.44092,153,0.251231527,
00.68.14,661,608,1269,869,0.68,0.58458,508,0.400315209,
00.68.15,574,631,1205,783,0.65,0.45083,353,0.292946058,
00.68.16,778,853,1631,1045,0.64,0.46507,486,0.297976701,
00.68.17,1106,1077,2183,752,0.34,0.46277,348,0.159413651,
00.68.18,299,317,616,380,0.62,0.56316,214,0.347402597,
00.68.19,542,580,1122,577,0.51,0.55113,318,0.28342246,
00.68.20,272,265,537,171,0.32,0.52632,90,0.167597765,
00.68.21,954,942,1896,1176,0.62,0.44813,527,0.277953586,
00.68.22,638,592,1230,707,0.57,0.471,333,0.270731707,
00.69.01,982,814,1796,1071,0.6,0.49767,533,0.296770601,
00.69.02,880,836,1716,1060,0.62,0.51509,546,0.318181818,
00.69.03,703,784,1487,988,0.66,0.49393,488,0.328177539,
00.69.04,490,480,970,635,0.65,0.51024,324,0.334020619,
00.69.05,256,269,525,375,0.71,0.60533,227,0.432380952,
00.69.06,770,761,1531,1026,0.67,0.58187,597,0.389941215,
00.69.07,882,839,1721,1032,0.6,0.49903,515,0.299244625,
00.69.08,578,652,1230,773,0.63,0.55757,431,0.350406504,
00.69.09,534,535,1069,708,0.66,0.47458,336,0.314312442,
00.69.10,899,890,1789,1229,0.69,0.49959,614,0.343208496,
00.69.11,151,172,323,229,0.71,0.64629,148,0.458204334,
00.69.12,696,744,1440,904,0.63,0.60951,551,0.382638889,
00.69.13,680,683,1363,821,0.6,0.5676,466,0.341892883,
00.69.14,652,680,1332,828,0.62,0.52657,436,0.327327327,
00.69.15,860,795,1655,1089,0.66,0.52158,568,0.343202417,
00.69.16,430,452,882,572,0.65,0.54021,309,0.350340136,
00.70.01,766,617,1383,779,0.56,0.58665,457,0.33044107,
00.70.02,1165,1006,2171,1297,0.6,0.51812,672,0.309534777,
00.70.03,1193,1089,2282,1292,0.57,0.54644,706,0.309377739,
00.70.04,1158,1035,2193,1235,0.56,0.55142,681,0.310533516,
00.70.05,759,654,1413,823,0.58,0.64763,533,0.377211607,
00.70.06,1035,945,1980,979,0.49,0.54341,532,0.268686869,
00.70.07,768,658,1426,867,0.61,0.49827,432,0.302945302,
00.70.08,684,574,1258,754,0.6,0.54775,413,0.328298887,
00.70.09,757,657,1414,867,0.61,0.66667,578,0.408769448,
00.70.10,759,652,1411,758,0.54,0.56728,430,0.304748405,
00.70.11,778,631,1409,768,0.55,0.46875,360,0.255500355,
00.70.12,1300,1050,2350,1388,0.59,0.4611,640,0.272340426,
00.70.13,766,642,1408,797,0.57,0.51192,408,0.289772727,
00.70.14,884,694,1578,854,0.54,0.51639,441,0.279467681,
00.70.15,815,645,1460,798,0.55,0.46867,374,0.256164384,
00.70.16,1394,1192,2586,1355,0.52,0.5321,721,0.278808971,
00.70.17,635,591,1226,675,0.55,0.51111,345,0.281402936,
00.70.18,926,827,1753,905,0.52,0.43646,395,0.225328009,
00.70.19,748,670,1418,781,0.55,0.46351,362,0.25528914,
00.70.20,693,611,1304,650,0.5,0.50462,328,0.251533742,
00.70.21,789,717,1506,725,0.48,0.48138,349,0.231739708,
00.70.22,1306,1092,2398,1295,0.54,0.48494,628,0.261884904,
00.70.23,1734,1451,3185,1241,0.39,0.42627,529,0.166091052,
00.79.01,1076,842,1918,1068,0.56,0.46536,497,0.259124088,
00.79.02,1384,1065,2449,1409,0.58,0.45635,643,0.262556145,
00.79.03,1575,1139,2714,1568,0.58,0.47832,750,0.276344878,
00.79.04,1696,1286,2982,1560,0.52,0.46603,727,0.24379611,
00.79.05,1534,1185,2719,1597,0.59,0.3995,638,0.23464509,
00.79.06,797,644,1441,930,0.65,0.47312,440,0.305343511,
00.79.07,1323,1028,2351,1425,0.61,0.47298,674,0.286686516,
00.79.08,1519,1162,2681,1632,0.61,0.45895,749,0.279373368,
00.79.09,894,670,1564,1005,0.64,0.45274,455,0.290920716,
00.79.10,1030,783,1813,1111,0.61,0.42304,470,0.259238831,
00.79.11,977,750,1727,1042,0.6,0.47985,500,0.289519398,
00.79.12,998,718,1716,1082,0.63,0.43808,474,0.276223776,
00.79.13,970,715,1685,1056,0.63,0.51136,540,0.320474777,
00.79.14,911,671,1582,994,0.63,0.47284,470,0.297092288,
00.79.15,896,677,1573,926,0.59,0.43952,407,0.258741259,
00.79.16,931,771,1702,1063,0.62,0.49483,526,0.309048179,
00.79.17,903,717,1620,959,0.59,0.41293,396,0.244444444,
00.79.18,815,613,1428,848,0.59,0.50708,430,0.301120448,
00.79.19,1174,857,2031,1162,0.57,0.46816,544,0.267848351,
00.79.20,912,697,1609,880,0.55,0.54773,482,0.299564947,
00.79.21,895,778,1673,971,0.58,0.50154,487,0.291093843,
00.79.22,937,743,1680,1094,0.65,0.53108,581,0.345833333,
00.79.23,1016,867,1883,1216,0.65,0.46711,568,0.301646309,
00.79.24,1673,1370,3043,1598,0.53,0.47121,753,0.247453171,
00.79.25,733,671,1404,860,0.61,0.50698,436,0.310541311,
00.79.26,943,767,1710,1004,0.59,0.44323,445,0.260233918,
00.79.27,799,693,1492,845,0.57,0.49467,418,0.280160858,
00.79.28,945,722,1667,1016,0.61,0.48327,491,0.294541092,
00.79.29,1052,797,1849,1041,0.56,0.47743,497,0.268793943,
00.79.30,965,769,1734,1079,0.62,0.48285,521,0.300461361,
00.79.31,1034,842,1876,958,0.51,0.5,479,0.25533049,
00.79.32,1584,1269,2853,1576,0.55,0.44416,700,0.245355766,
00.79.33,903,700,1603,958,0.6,0.48017,460,0.286961946,
00.79.34,766,637,1403,881,0.63,0.4597,405,0.288667142,
00.79.35,909,680,1589,933,0.59,0.44051,411,0.258653241,
00.79.36,736,637,1373,797,0.58,0.45922,366,0.266569556,
00.79.37,834,688,1522,892,0.59,0.51682,461,0.302890933,
00.79.38,968,770,1738,1099,0.63,0.48408,532,0.306098964,
00.79.39,836,646,1482,841,0.57,0.45422,382,0.257759784,
00.79.40,869,777,1646,967,0.59,0.49741,481,0.292223572,
00.79.41,867,653,1520,932,0.61,0.47639,444,0.292105263,
00.79.42,1056,817,1873,1071,0.57,0.48739,522,0.278697277,
00.79.43,1545,1282,2827,1496,0.53,0.4873,729,0.257870534,
00.79.44,899,710,1609,941,0.58,0.47821,450,0.279676818,
00.79.45,872,745,1617,1059,0.65,0.52786,559,0.345701917,
00.79.46,1562,1306,2868,1217,0.42,0.38948,474,0.165271967,
00.79.47,1008,802,1810,1020,0.56,0.45,459,0.25359116,
00.79.48,883,706,1589,1051,0.66,0.46813,492,0.309628697,
00.79.49,1177,965,2142,1189,0.56,0.50463,600,0.280112045,
00.79.50,1194,1003,2197,1277,0.58,0.4863,621,0.28265817,
00.79.51,1648,1259,2907,1582,0.54,0.46903,742,0.255245958,
00.79.52,715,666,1381,825,0.6,0.57576,475,0.343953657,
00.79.53,726,632,1358,887,0.65,0.58625,520,0.382916053,
00.79.54,785,788,1573,995,0.63,0.60704,604,0.383979657,
00.79.55,751,659,1410,821,0.58,0.49208,404,0.286524823,
00.79.56,794,731,1525,853,0.56,0.49355,421,0.276065574,
00.79.57,735,816,1551,977,0.63,0.57216,559,0.360412637,
00.79.58,629,601,1230,729,0.59,0.49383,360,0.292682927,
00.79.59,728,681,1409,873,0.62,0.47194,412,0.292405962,
00.79.60,748,717,1465,921,0.63,0.56026,516,0.35221843,
00.79.61,570,476,1046,637,0.61,0.60754,387,0.36998088,
00.79.62,811,773,1584,935,0.59,0.56578,529,0.333964646,
00.79.63,742,682,1424,882,0.62,0.63832,563,0.395365169,
00.79.64,744,651,1395,777,0.56,0.51866,403,0.288888889,
00.79.65,404,398,802,521,0.65,0.61804,322,0.401496259,
00.79.66,1397,1205,2602,1583,0.61,0.52937,838,0.322059954,
00.79.67,883,698,1581,1010,0.64,0.47228,477,0.30170778,
00.79.68,863,693,1556,1006,0.65,0.47614,479,0.307840617,
00.79.69,1026,746,1772,1048,0.59,0.5124,537,0.303047404,
00.79.70,972,790,1762,1058,0.6,0.48204,510,0.289443814,
00.79.71,930,748,1678,1001,0.6,0.44555,446,0.26579261,
00.79.72,824,680,1504,823,0.55,0.45565,375,0.249335106,
00.79.73,871,776,1647,948,0.58,0.43565,413,0.250758956,
00.79.74,842,684,1526,841,0.55,0.47206,397,0.260157274,
00.79.75,862,688,1550,941,0.61,0.43677,411,0.26516129,
00.79.76,870,651,1521,910,0.6,0.49011,446,0.293228139,
00.79.77,906,795,1701,1046,0.61,0.47992,502,0.295120517,
00.79.78,614,583,1197,739,0.62,0.52233,386,0.322472849,
00.79.79,680,503,1183,668,0.56,0.56587,378,0.319526627,
00.79.80,759,650,1409,818,0.58,0.42665,349,0.2476934,
00.79.81,606,565,1171,761,0.65,0.54402,414,0.35354398,
00.79.82,691,741,1432,880,0.61,0.49318,434,0.303072626,
00.79.83,531,518,1049,661,0.63,0.55522,367,0.349857007,
00.79.84,770,738,1508,938,0.62,0.58635,550,0.364721485,
00.79.85,825,856,1681,1113,0.66,0.55166,614,0.365258775,
00.79.86,798,740,1538,1073,0.7,0.62535,671,0.436280884,
00.79.87,812,741,1553,999,0.64,0.53554,535,0.344494527,
00.79.88,635,588,1223,731,0.6,0.65663,480,0.392477514,
00.79.89,1325,1051,2376,1788,0.75,0.74273,1328,0.558922559,
00.79.90,0,0,0,50,0,0.82,41,0,
00.80.01,715,617,1332,1008,0.76,0.63194,637,0.478228228,
00.80.02,428,426,854,642,0.75,0.66044,424,0.496487119,
00.80.03,132,167,299,238,0.8,0.69748,166,0.555183946,
00.80.04,260,242,502,384,0.76,0.69792,268,0.533864542,
00.80.05,126,140,266,200,0.75,0.725,145,0.545112782,
00.80.06,200,210,410,293,0.71,0.60751,178,0.434146341,
00.80.07,318,312,630,441,0.7,0.62585,276,0.438095238,
00.80.08,140,158,298,229,0.77,0.59389,136,0.456375839,
00.80.09,275,308,583,397,0.68,0.56423,224,0.384219554,
00.80.10,182,187,369,277,0.75,0.67509,187,0.506775068,
00.80.11,190,213,403,309,0.77,0.61812,191,0.473945409,
00.80.12,215,227,442,337,0.76,0.65875,222,0.502262443,
00.80.13,346,356,702,508,0.72,0.75394,383,0.545584046,
00.80.14,272,305,577,384,0.67,0.70313,270,0.467937608,
00.80.15,372,367,739,505,0.68,0.69307,350,0.473612991,
00.80.16,293,270,563,389,0.69,0.62725,244,0.43339254,
00.80.17,413,446,859,654,0.76,0.66514,435,0.506402794,
00.80.18,80,107,187,157,0.84,0.75159,118,0.631016043,
00.80.19,222,247,469,339,0.72,0.63717,216,0.460554371,
00.80.20,132,144,276,227,0.82,0.74449,169,0.612318841,
00.80.21,246,238,484,374,0.77,0.71925,269,0.555785124,
00.80.22,208,235,443,343,0.77,0.63557,218,0.492099323,
00.80.23,102,119,221,171,0.77,0.68421,117,0.529411765,
00.80.24,246,268,514,376,0.73,0.73404,276,0.536964981,
00.80.25,241,253,494,355,0.72,0.71549,254,0.51417004,
00.80.26,252,273,525,357,0.68,0.76471,273,0.52,
00.80.27,201,203,404,297,0.74,0.82155,244,0.603960396,
00.80.28,621,612,1233,904,0.73,0.72235,653,0.529602595,
00.80.29,252,251,503,356,0.71,0.63764,227,0.451292247,
00.81.01,468,366,834,568,0.68,0.6919,393,0.471223022,
00.81.02,575,438,1013,569,0.56,0.61863,352,0.347482725,
00.81.03,585,540,1125,617,0.55,0.62399,385,0.342222222,
00.81.04,489,407,896,512,0.57,0.66992,343,0.3828125,
00.81.05,1251,1007,2258,1326,0.59,0.59502,789,0.349424269,
00.81.06,358,292,650,430,0.66,0.61163,263,0.404615385,
00.81.07,957,741,1698,981,0.58,0.60856,597,0.351590106,
00.81.08,674,532,1206,739,0.61,0.62246,460,0.381426202,
00.81.09,443,373,816,515,0.63,0.66019,340,0.416666667,
00.81.10,698,585,1283,797,0.62,0.66876,533,0.41543258,
00.81.11,734,624,1358,866,0.64,0.61663,534,0.393225331,
00.81.12,548,497,1045,702,0.67,0.7265,510,0.488038278,
00.81.13,152,176,328,229,0.7,0.56332,129,0.393292683,
00.81.14,1002,949,1951,1156,0.59,0.60727,702,0.359815479,
00.81.15,738,798,1536,1062,0.69,0.53013,563,0.366536458,
00.81.16,508,519,1027,701,0.68,0.50499,354,0.344693281,
00.81.17,611,663,1274,850,0.67,0.72353,615,0.482731554,
00.81.18,259,303,562,347,0.62,0.68012,236,0.419928826,
00.81.19,347,355,702,473,0.67,0.57717,273,0.388888889,
00.81.20,420,425,845,556,0.66,0.66906,372,0.440236686,
00.81.21,530,582,1112,736,0.66,0.59918,441,0.396582734,
00.81.22,1144,1175,2319,1265,0.55,0.60158,761,0.328158689,
00.81.23,272,320,592,386,0.65,0.59067,228,0.385135135,
00.81.24,619,643,1262,769,0.61,0.63329,487,0.385895404,
00.81.25,600,611,1211,751,0.62,0.61917,465,0.383980182,
00.81.26,97,109,206,155,0.75,0.60645,94,0.45631068,
00.81.27,643,630,1273,825,0.65,0.62182,513,0.402985075,
00.81.28,578,571,1149,680,0.59,0.63382,431,0.37510879,
00.81.29,406,437,843,536,0.64,0.77239,414,0.491103203,
00.81.30,585,524,1109,661,0.6,0.63843,422,0.380522994,
00.81.31,670,706,1376,881,0.64,0.60726,535,0.38880814,
00.81.32,924,1006,1930,1109,0.57,0.70424,781,0.404663212,
00.81.33,739,775,1514,923,0.61,0.73348,677,0.447159841,
00.81.34,222,256,478,282,0.59,0.82624,233,0.487447699,
00.81.35,614,672,1286,720,0.56,0.69722,502,0.390357698,
00.81.36,980,1043,2023,1096,0.54,0.70073,768,0.379634207,
00.81.37,824,895,1719,1040,0.61,0.69135,719,0.418266434,
00.81.38,251,284,535,326,0.61,0.75153,245,0.457943925,
00.81.39,304,295,599,359,0.6,0.66017,237,0.395659432,
00.81.40,380,406,786,486,0.62,0.64403,313,0.39821883,
00.81.41,487,468,955,569,0.6,0.65378,372,0.389528796,
00.81.42,1115,967,2082,1214,0.58,0.57908,703,0.3376561,
00.81.43,930,958,1888,1046,0.55,0.59369,621,0.328919492,
00.81.44,595,691,1286,858,0.67,0.58275,500,0.388802488,
00.81.45,318,327,645,419,0.65,0.4821,202,0.313178295,
00.81.46,555,657,1212,731,0.6,0.61149,447,0.368811881,
00.81.47,320,335,655,432,0.66,0.60648,262,0.4,
00.81.48,496,480,976,536,0.55,0.625,335,0.343237705,
00.81.49,435,457,892,525,0.59,0.60571,318,0.356502242,
00.81.50,695,793,1488,992,0.67,0.65827,653,0.438844086,
00.81.51,532,533,1065,680,0.64,0.64559,439,0.412206573,
00.81.52,692,724,1416,841,0.59,0.53508,450,0.31779661,
00.81.53,447,478,925,603,0.65,0.4743,286,0.309189189,
00.81.54,670,746,1416,773,0.55,0.60931,471,0.332627119,
00.81.55,691,710,1401,890,0.64,0.57528,512,0.365453248,
00.81.56,640,659,1299,787,0.61,0.63787,502,0.386451116,
00.81.57,453,452,905,593,0.66,0.63744,378,0.417679558,
00.82.01,537,486,1023,674,0.66,0.6365,429,0.419354839,
00.82.02,101,116,217,127,0.59,0.62205,79,0.3640553,
00.82.03,166,157,323,231,0.72,0.41558,96,0.297213622,
00.82.04,194,221,415,242,0.58,0.59091,143,0.344578313,
00.82.05,222,241,463,287,0.62,0.62021,178,0.384449244,
00.82.06,168,212,380,236,0.62,0.53814,127,0.334210526,
00.82.07,77,86,163,97,0.6,0.62887,61,0.374233129,
00.82.08,54,56,110,72,0.65,0.56944,41,0.372727273,
00.82.09,164,162,326,214,0.66,0.59813,128,0.392638037,
00.82.10,147,173,320,236,0.74,0.63136,149,0.465625,
00.82.11,66,63,129,92,0.71,0.77174,71,0.550387597,
00.82.12,99,101,200,146,0.73,0.73288,107,0.535,
00.82.13,81,74,155,112,0.72,0.60714,68,0.438709677,
00.82.14,295,303,598,392,0.66,0.625,245,0.409698997,
00.82.15,314,330,644,413,0.64,0.57627,238,0.369565217,
00.82.16,293,321,614,417,0.68,0.42446,177,0.288273616,
00.82.17,207,216,423,279,0.66,0.57706,161,0.380614657,
00.82.18,100,82,182,136,0.75,0.72794,99,0.543956044,
00.82.19,55,41,96,82,0.85,0.67073,55,0.572916667,
00.82.20,171,165,336,220,0.65,0.65455,144,0.428571429,
00.82.21,108,98,206,157,0.76,0.66242,104,0.504854369,
00.82.22,61,62,123,89,0.72,0.79775,71,0.577235772,
00.82.23,210,233,443,301,0.68,0.57143,172,0.388261851,
00.82.24,90,94,184,138,0.75,0.80435,111,0.60326087,
00.82.25,114,141,255,173,0.68,0.52601,91,0.356862745,
00.82.26,116,112,228,146,0.64,0.67123,98,0.429824561,
00.82.27,117,126,243,165,0.68,0.75152,124,0.510288066,
00.82.28,221,241,462,307,0.66,0.69055,212,0.458874459,
00.82.29,124,136,260,197,0.76,0.7665,151,0.580769231,
00.82.30,97,96,193,143,0.74,0.83217,119,0.616580311,
00.82.31,147,153,300,217,0.72,0.58525,127,0.423333333,
00.82.32,89,93,182,128,0.7,0.625,80,0.43956044,
00.82.33,61,77,138,85,0.62,0.61176,52,0.376811594,
00.82.34,116,123,239,154,0.64,0.71429,110,0.460251046,
00.82.35,88,89,177,92,0.52,0.78261,72,0.406779661,
00.82.36,135,148,283,149,0.53,0.73826,110,0.38869258,
00.82.37,122,125,247,133,0.54,0.6391,85,0.344129555,
00.82.38,212,205,417,261,0.63,0.55172,144,0.345323741,
00.82.39,223,238,461,263,0.57,0.65019,171,0.370932755,
00.82.40,126,132,258,159,0.62,0.61635,98,0.379844961,
00.82.41,177,172,349,204,0.58,0.54412,111,0.318051576,
00.82.42,178,187,365,233,0.64,0.71245,166,0.454794521,
00.82.43,200,194,394,264,0.67,0.66288,175,0.444162437,
00.82.44,74,85,159,139,0.87,0.79856,111,0.698113208,
00.82.45,140,130,270,175,0.65,0.61714,108,0.4,
00.82.46,100,96,196,132,0.67,0.68182,90,0.459183673,
00.82.47,106,107,213,157,0.74,0.6242,98,0.460093897,
00.82.48,41,51,92,73,0.79,0.63014,46,0.5,
00.83.01,615,636,1251,810,0.65,0.62716,508,0.40607514,
00.83.02,515,494,1009,648,0.64,0.5216,338,0.334985134,
00.83.03,680,661,1341,889,0.66,0.67267,598,0.445935869,
00.83.04,228,259,487,295,0.61,0.62712,185,0.379876797,
00.83.05,1047,1159,2206,1470,0.67,0.66259,974,0.441523119,
00.83.06,355,408,763,516,0.68,0.61628,318,0.416775885,
00.83.07,728,730,1458,889,0.61,0.60292,536,0.367626886,
00.83.08,413,419,832,544,0.65,0.65809,358,0.430288462,
00.83.09,281,292,573,386,0.67,0.65803,254,0.443280977,
00.83.10,602,675,1277,752,0.59,0.67686,509,0.398590446,
00.83.11,548,619,1167,709,0.61,0.58956,418,0.358183376,
00.83.12,628,649,1277,705,0.55,0.50355,355,0.277995301,
00.83.13,683,706,1389,829,0.6,0.50905,422,0.303815695,
00.83.14,531,600,1131,699,0.62,0.58369,408,0.360742706,
00.83.15,595,666,1261,762,0.6,0.62073,473,0.375099128,
00.83.16,1182,1258,2440,1359,0.56,0.53716,730,0.299180328,
00.83.17,873,901,1774,1002,0.56,0.56986,571,0.321871477,
00.83.18,556,602,1158,622,0.54,0.59164,368,0.317789292,
00.83.19,497,559,1056,615,0.58,0.57236,352,0.333333333,
00.83.20,463,468,931,562,0.6,0.51068,287,0.308270677,
00.83.21,694,742,1436,819,0.57,0.63858,523,0.364206128,
00.83.22,259,280,539,338,0.63,0.62722,212,0.393320965,
00.83.23,225,206,431,280,0.65,0.48929,137,0.317865429,
00.83.24,357,369,726,598,0.82,0.46321,277,0.3815427,
00.83.25,515,680,1195,838,0.7,0.5537,464,0.388284519,
00.83.26,614,656,1270,861,0.68,0.56562,487,0.383464567,
00.83.27,738,704,1442,986,0.68,0.59533,587,0.407073509,
00.83.28,573,590,1163,764,0.66,0.62958,481,0.413585555,
00.83.29,471,530,1001,625,0.62,0.584,365,0.364635365,
00.83.30,912,963,1875,1278,0.68,0.58216,744,0.3968,
00.83.31,388,438,826,518,0.63,0.63127,327,0.395883777,
00.83.32,688,743,1431,861,0.6,0.62369,537,0.375262055,
00.83.33,119,147,266,171,0.64,0.56725,97,0.364661654,
00.83.34,619,681,1300,894,0.69,0.69239,619,0.476153846,
00.83.35,308,320,628,397,0.63,0.74559,296,0.47133758,
00.83.36,268,268,536,335,0.63,0.62985,211,0.393656716,
00.83.37,163,176,339,257,0.76,0.68093,175,0.516224189,
00.83.38,237,260,497,335,0.67,0.70448,236,0.474849095,
00.83.39,160,168,328,254,0.77,0.70472,179,0.545731707,
00.83.40,369,383,752,581,0.77,0.65749,382,0.507978723,
00.83.41,251,258,509,344,0.68,0.60174,207,0.406679764,
00.84.01,889,725,1614,1117,0.69,0.59534,665,0.412019827,
00.84.02,241,234,475,276,0.58,0.78261,216,0.454736842,
00.84.03,189,176,365,215,0.59,0.70698,152,0.416438356,
00.84.04,420,455,875,571,0.65,0.69002,394,0.450285714,
00.84.05,269,262,531,318,0.6,0.73585,234,0.440677966,
00.84.06,173,197,370,226,0.61,0.71239,161,0.435135135,
00.84.07,308,298,606,351,0.58,0.61538,216,0.356435644,
00.84.08,217,223,440,287,0.65,0.60279,173,0.393181818,
00.84.09,199,225,424,290,0.68,0.55172,160,0.377358491,
00.84.10,295,342,637,428,0.67,0.59346,254,0.398744113,
00.84.11,475,488,963,651,0.68,0.45929,299,0.310488058,
00.84.12,168,184,352,244,0.69,0.68443,167,0.474431818,
00.84.13,275,280,555,337,0.61,0.77448,261,0.47027027,
00.84.14,169,173,342,224,0.65,0.63393,142,0.415204678,
00.84.15,187,165,352,239,0.68,0.7113,170,0.482954545,
00.84.16,309,325,634,379,0.6,0.56201,213,0.335962145,
00.84.17,561,540,1101,747,0.68,0.72557,542,0.492279746,
00.84.18,379,374,753,543,0.72,0.77716,422,0.560424967,
00.84.19,112,101,213,140,0.66,0.70714,99,0.464788732,
00.84.20,156,139,295,191,0.65,0.73822,141,0.477966102,
00.84.21,109,127,236,114,0.48,0.62281,71,0.300847458,
00.84.22,323,394,717,332,0.46,0.62651,208,0.290097629,
00.84.23,277,277,554,390,0.7,0.78462,306,0.55234657,
00.84.24,207,193,400,252,0.63,0.60317,152,0.38,
00.84.25,218,233,451,270,0.6,0.70741,191,0.423503326,
00.84.26,206,222,428,273,0.64,0.63736,174,0.406542056,
00.84.27,154,153,307,128,0.42,0.65625,84,0.273615635,
00.84.28,116,119,235,143,0.61,0.54545,78,0.331914894,
00.84.29,98,107,205,147,0.72,0.73469,108,0.526829268,
00.84.30,215,263,478,293,0.61,0.6314,185,0.387029289,
00.84.31,298,297,595,360,0.61,0.60556,218,0.366386555,
00.84.32,159,166,325,187,0.58,0.71658,134,0.412307692,
00.84.33,74,88,162,93,0.57,0.82796,77,0.475308642,
00.84.34,123,123,246,149,0.61,0.67785,101,0.410569106,
00.84.35,206,213,419,257,0.61,0.67704,174,0.415274463,
00.84.36,213,193,406,241,0.59,0.58091,140,0.344827586,
00.84.37,122,97,219,123,0.56,0.62602,77,0.351598174,
00.84.38,207,225,432,254,0.59,0.74016,188,0.435185185,
00.84.39,252,244,496,277,0.56,0.79061,219,0.441532258,
00.84.40,271,264,535,327,0.61,0.71254,233,0.435514019,
00.84.41,281,302,583,317,0.54,0.7224,229,0.392795883,
00.84.42,75,75,150,75,0.5,0.86667,65,0.433333333,
00.84.43,87,112,199,88,0.44,0.76136,67,0.336683417,
00.84.44,141,149,290,180,0.62,0.71111,128,0.44137931,
00.84.45,127,134,261,203,0.78,0.7734,157,0.601532567,
00.84.46,62,60,122,80,0.66,0.55,44,0.360655738,
00.84.47,52,63,115,60,0.52,0.56667,34,0.295652174,
00.84.48,203,184,387,227,0.59,0.69163,157,0.405684755,
00.84.49,171,183,354,257,0.73,0.86381,222,0.627118644,
00.84.50,140,145,285,178,0.62,0.68539,122,0.428070175,
00.84.51,85,80,165,106,0.64,0.58491,62,0.375757576,
00.84.52,134,131,265,202,0.76,0.77228,156,0.588679245,
00.84.53,150,152,302,184,0.61,0.625,115,0.380794702,
